ï»¿annee,cumul_periode,rss,region,nom_etablissement,nom_installation,no_permis_installation,nb_visites_total,nb_usagers_75ans_et_plus_total,nb_usagers_sante_mentale_total,dms_total,nb_usagers_pec_total,delai_pec_total,nb_visites_ambulatoire,nb_usagers_75ans_et_plus_amb,nb_usagers_sante_mentale_amb,dms_ambulatoire,nb_usagers_pec_ambulatoire,delai_pec_ambulatoire,nb_visites_sur_civiere,nb_usagers_sur_civiere_plus_24h,nb_usagers_sur_civiere_plus_48h,dms_sur_civiere,nb_usagers_pec_sur_civiere,delai_pec_sur_civiere,nb_usagers_75ans_et_plus_civ,nb_usagers_sante_mentale_civ
2020-2021,4,99,Total provincial,Total provincial,Total provincial,,756224,119027,51275,7.4380261929,653375,1.6363697902,477095,38958,19547,3.4406244435,376504,1.9325445731,279129,47712,9635,14.270495724,276871,1.2336154734,80069,31728
2021-2022,4,99,Total provincial,Total provincial,Total provincial,,979856,147145,61003,8.2427559438,806499,2.4322318923,656615,53464,25133,4.4767445742,485998,2.8996078745,323241,66091,15477,15.892836087,320501,1.723517122,93681,35870
2022-2023,4,99,Total provincial,Total provincial,Total provincial,,1085838,160682,61787,8.7517545967,857958,2.7927444898,751926,59965,25323,4.8353004207,527850,3.311543594,333912,77376,23462,17.571095389,330108,1.9631732367,100717,36464
2023-2024,4,99,Total provincial,Total provincial,Total provincial,,1037164,166416,61290,8.6737049214,840233,2.713044225,697532,63745,24172,4.7758771047,504191,3.2083854344,339632,73789,18723,16.679015471,336042,1.9698437332,102671,37118
2024-2025,4,99,Total provincial,Total provincial,Total provincial,,1205058,197983,70333,8.6074009123,972167,2.9263580997,809898,75924,27545,4.9339140968,581550,3.4736246138,395160,82427,18640,16.136375568,390617,2.1115885396,122059,42788
2020-2021,4,08,Abitibi-TÃ©miscamingue,Total rÃ©gional,Total rÃ©gional,,23566,2979,1467,4.4096645473,20532,1.6063206485,18837,1630,1084,3.0774266957,15816,1.7496196538,4729,330,25,9.7163603416,4716,1.1257402695,1349,383
2020-2021,4,01,Bas-Saint-Laurent,Total rÃ©gional,Total rÃ©gional,,27720,5035,1282,3.7025689935,24064,1.1970534362,19602,2223,737,2.374988394,16021,1.3191725444,8118,59,0,6.908190441,8043,0.953802133,2812,545
2020-2021,4,03,Capitale-Nationale,Total rÃ©gional,Total rÃ©gional,,83721,13674,5483,6.8566745832,72418,1.3501633955,52448,4660,1742,3.0496653405,41241,1.6538244102,31273,4364,806,13.241416078,31177,0.9484799781,9014,3741
2020-2021,4,12,ChaudiÃ¨re-Appalaches,Total rÃ©gional,Total rÃ©gional,,42018,7345,2123,5.264515459,36147,0.8440456792,28797,2677,945,2.2962168609,22942,1.003549676,13221,1283,33,11.729842948,13205,0.5669278682,4668,1178
2020-2021,4,09,CÃ´te-Nord,Total rÃ©gional,Total rÃ©gional,,20369,2434,1125,5.4095947,16841,1.6621599239,15509,1257,644,2.779881807,12196,1.7071555109,4860,701,299,13.801408951,4645,1.5440186581,1177,481
2020-2021,4,05,Estrie,Total rÃ©gional,Total rÃ©gional,,52561,8088,3241,6.5299079271,45567,1.8592790409,31829,2433,1034,3.493257145,24931,2.2925393196,20732,2115,297,11.191954895,20636,1.3358436847,5655,2207
2020-2021,4,11,GaspÃ©sie-Ãles-de-la-Madeleine,Total rÃ©gional,Total rÃ©gional,,19664,3168,826,4.2683773789,17767,1.0533127271,15037,1686,554,2.3244909778,13218,1.1232080202,4627,430,124,10.585693094,4549,0.8502184241,1482,272
2020-2021,4,14,LanaudiÃ¨re,Total rÃ©gional,Total rÃ©gional,,32082,4993,2194,8.2308632826,26437,1.8882578919,19405,1345,995,3.9376659652,13865,2.3750161077,12677,2398,243,14.802567467,12572,1.3514377629,3648,1199
2020-2021,4,15,Laurentides,Total rÃ©gional,Total rÃ©gional,,44775,6711,3180,9.3565711521,37009,2.5006747458,27314,2214,1091,4.6488517285,19678,3.1090299517,17461,3603,919,16.720791319,17331,1.8099348149,4497,2089
2020-2021,4,13,Laval,Total rÃ©gional,Total rÃ©gional,,20050,3639,1446,8.1864555556,16219,1.8921542978,12519,964,416,3.885914277,8705,2.4475194971,7531,1382,110,15.335370211,7514,1.2487614231,2675,1030
2020-2021,4,04,Mauricie et Centre-du-QuÃ©bec,Total rÃ©gional,Total rÃ©gional,,52540,8862,3307,5.8476148067,43668,1.6879096567,32518,2628,1134,2.9294234048,23842,2.0561745612,20022,1718,53,10.587088786,19826,1.2450481691,6234,2173
2020-2021,4,06,MontrÃ©al,Total rÃ©gional,Total rÃ©gional,,174473,25773,15060,9.705554102,160413,1.5464319392,97585,6108,5079,4.1882876353,84369,1.9309144387,76888,18082,4373,16.707979034,76044,1.119857798,19665,9981
2020-2021,4,16,MontÃ©rÃ©gie,Total rÃ©gional,Total rÃ©gional,,86829,15111,6186,9.198835796,73689,1.8762802717,54833,4605,2438,3.893419732,41782,2.2478039786,31996,8593,1935,18.290968533,31907,1.3897724985,10506,3748
2020-2021,4,07,Outaouais,Total rÃ©gional,Total rÃ©gional,,35611,4944,2280,6.6570504978,27087,2.1071110475,24785,2095,964,3.279511667,16421,2.1042652024,10826,1910,387,14.389574045,10666,2.111492411,2849,1316
2020-2021,4,02,Saguenay-Lac-Saint-Jean,Total rÃ©gional,Total rÃ©gional,,40245,6271,2075,5.0228939482,35517,1.6159536044,26077,2433,690,2.7178640394,21477,1.8128187906,14168,744,31,9.2654309987,14040,1.3148087607,3838,1385
2021-2022,4,08,Abitibi-TÃ©miscamingue,Total rÃ©gional,Total rÃ©gional,,31062,3470,1985,5.6042906392,25848,2.4866622391,25291,1971,1456,4.1846928749,20117,2.7460206404,5771,714,108,11.825577601,5731,1.5762603967,1499,529
2021-2022,4,01,Bas-Saint-Laurent,Total rÃ©gional,Total rÃ©gional,,35903,5952,1588,3.9980348052,31418,1.6052899789,26719,2925,962,2.8555379859,22343,1.7828535534,9184,140,0,7.3218994084,9075,1.16812161,3027,626
2021-2022,4,03,Capitale-Nationale,Total rÃ©gional,Total rÃ©gional,,103510,16493,6127,7.11243042,87053,1.8184807371,68029,6242,2068,3.7298821744,51697,2.3080718632,35481,5508,818,13.597912075,35356,1.1026081146,10251,4059
2021-2022,4,12,ChaudiÃ¨re-Appalaches,Total rÃ©gional,Total rÃ©gional,,54230,9058,2796,5.9620789436,46906,1.2695861581,38509,3664,1291,2.876142756,31198,1.5155401343,15721,2344,178,13.521160214,15708,0.7810916235,5394,1505
2021-2022,4,09,CÃ´te-Nord,Total rÃ©gional,Total rÃ©gional,,27059,3131,1527,6.0707117472,21705,2.2776747933,20901,1678,881,3.4561719535,15698,2.3722934981,6158,1089,426,14.94477739,6007,2.0304091985,1453,646
2021-2022,4,05,Estrie,Total rÃ©gional,Total rÃ©gional,,66086,10050,3652,7.5949218317,54950,2.7130159488,41921,3354,1289,4.5876823668,30941,3.4551995105,24165,3405,547,12.81182585,24009,1.7565453927,6696,2363
2021-2022,4,11,GaspÃ©sie-Ãles-de-la-Madeleine,Total rÃ©gional,Total rÃ©gional,,26058,4201,1032,4.5600594401,23085,1.4747463119,20723,2496,717,2.851494515,17830,1.5727067053,5335,579,108,11.196721285,5255,1.1423707051,1705,315
2021-2022,4,14,LanaudiÃ¨re,Total rÃ©gional,Total rÃ©gional,,41839,6706,2668,10.033437131,32017,3.3366049547,27345,2131,1408,5.997825674,17609,4.2953297398,14494,4174,480,17.647194222,14408,2.1648819714,4575,1260
2021-2022,4,15,Laurentides,Total rÃ©gional,Total rÃ©gional,,54885,8557,3597,11.739520624,41903,3.6974762282,36341,3121,1290,6.279401984,23484,4.6506953789,18544,6319,2154,22.439810286,18419,2.4821334552,5436,2307
2021-2022,4,13,Laval,Total rÃ©gional,Total rÃ©gional,,26760,4467,1670,8.3012162224,20848,2.8899156594,17738,1413,523,5.0047934128,11851,3.7026548861,9022,1440,74,14.782256767,8997,1.8193618552,3054,1147
2021-2022,4,04,Mauricie et Centre-du-QuÃ©bec,Total rÃ©gional,Total rÃ©gional,,69801,11305,3857,6.4592433609,55364,2.6082268662,46010,3809,1370,3.994288319,31931,3.1552680867,23791,2412,61,11.226280538,23433,1.8628006207,7496,2487
2021-2022,4,06,MontrÃ©al,Total rÃ©gional,Total rÃ©gional,,245290,32990,18450,10.084354446,210962,2.4867888135,154213,9045,6890,5.3833702646,120739,3.1127611786,91077,23085,6221,18.044134341,90223,1.6490946845,23945,11560
2021-2022,4,16,MontÃ©rÃ©gie,Total rÃ©gional,Total rÃ©gional,,110187,18283,7098,10.087705272,82879,2.954601132,72442,6273,2999,4.9698216313,45333,3.5722052797,37745,10881,3126,19.910191078,37546,2.2089065487,12010,4099
2021-2022,4,07,Outaouais,Total rÃ©gional,Total rÃ©gional,,39465,5210,2571,8.0406910061,30449,2.2913716287,28440,2341,1133,3.7896617636,19612,2.2732637189,11025,2635,1063,19.006611338,10837,2.3241419827,2869,1438
2021-2022,4,02,Saguenay-Lac-Saint-Jean,Total rÃ©gional,Total rÃ©gional,,47721,7272,2385,5.76231432,41112,2.2083257862,31993,3001,856,3.3278752557,25615,2.4789516885,15728,1366,113,10.714311331,15497,1.7610080804,4271,1529
2022-2023,4,08,Abitibi-TÃ©miscamingue,Total rÃ©gional,Total rÃ©gional,,34224,3659,1856,5.9164838921,28233,2.9160538102,28405,2039,1349,4.6336856285,22447,3.2011071759,5819,731,98,12.178364744,5786,1.810178784,1620,507
2022-2023,4,01,Bas-Saint-Laurent,Total rÃ©gional,Total rÃ©gional,,42005,6475,1428,4.2091247801,36084,1.839392467,31818,3105,891,3.0417297512,26043,2.011791279,10187,256,15,7.8553577272,10041,1.3922475351,3370,537
2022-2023,4,03,Capitale-Nationale,Total rÃ©gional,Total rÃ©gional,,116697,18355,6202,7.2589252532,93829,1.9510259384,78584,7145,2214,3.6642025271,55929,2.4175362911,38113,6559,1556,14.670771361,37900,1.2625969804,11210,3988
2022-2023,4,12,ChaudiÃ¨re-Appalaches,Total rÃ©gional,Total rÃ©gional,,73326,11054,2960,6.0142100877,62286,1.745382202,56705,5022,1481,3.3259235713,45684,2.0447820839,16621,3479,541,15.185697177,16602,0.9215185587,6032,1479
2022-2023,4,09,CÃ´te-Nord,Total rÃ©gional,Total rÃ©gional,,31417,3382,1490,6.5731675438,24778,2.859682458,25045,1881,964,4.4895591158,18579,2.9940423327,6372,1078,435,14.762742729,6199,2.4569929738,1501,526
2022-2023,4,05,Estrie,Total rÃ©gional,Total rÃ©gional,,71581,10829,3759,8.3426408893,57974,3.112067076,46878,3689,1250,5.030586878,33397,4.0014109551,24703,4666,1088,14.627807385,24577,1.9035624771,7140,2509
2022-2023,4,11,GaspÃ©sie-Ãles-de-la-Madeleine,Total rÃ©gional,Total rÃ©gional,,30140,4756,1215,5.4101317186,26459,1.9112916315,24632,2923,823,3.4017676983,21069,2.0394613598,5508,921,311,14.391617294,5390,1.4102882911,1833,392
2022-2023,4,14,LanaudiÃ¨re,Total rÃ©gional,Total rÃ©gional,,44284,7358,2666,10.216644455,31385,3.7201019861,30205,2384,1464,6.0167476871,17367,4.6877632067,14079,4412,792,19.227077148,14018,2.5212596107,4974,1202
2022-2023,4,15,Laurentides,Total rÃ©gional,Total rÃ©gional,,57495,9051,3732,12.040593351,42025,3.8470417146,38920,3318,1288,6.173850855,23596,4.7327393885,18575,6831,2656,24.333116525,18429,2.7130180392,5733,2444
2022-2023,4,13,Laval,Total rÃ©gional,Total rÃ©gional,,28821,4788,1795,8.7517344799,21357,3.1129045252,19510,1435,564,5.3394210804,12077,3.9861801128,9311,1851,111,15.901797247,9280,1.9764229227,3353,1231
2022-2023,4,04,Mauricie et Centre-du-QuÃ©bec,Total rÃ©gional,Total rÃ©gional,,74373,11836,3863,7.5801108377,56604,3.2598258663,50056,3978,1188,4.8369944551,32656,4.0686501375,24317,3596,363,13.226754488,23948,2.1568959598,7858,2675
2022-2023,4,06,MontrÃ©al,Total rÃ©gional,Total rÃ©gional,,265538,35746,18501,10.890211983,214708,2.8959558033,169560,9936,6729,5.9443922686,120434,3.7427801927,95978,25900,8825,19.627768409,94274,1.8141469428,25810,11772
2022-2023,4,16,MontÃ©rÃ©gie,Total rÃ©gional,Total rÃ©gional,,113495,19187,6906,11.353428017,80191,3.5342053036,77540,6873,2850,5.5384055326,44426,4.1214554728,35955,12085,4942,23.894016069,35765,2.8047442099,12314,4056
2022-2023,4,07,Outaouais,Total rÃ©gional,Total rÃ©gional,,47392,5994,2744,8.1150327118,35666,2.7146616837,35414,2861,1248,4.1369131715,23897,2.7513978393,11978,3096,1420,19.876689533,11769,2.6400687777,3133,1496
2022-2023,4,02,Saguenay-Lac-Saint-Jean,Total rÃ©gional,Total rÃ©gional,,55050,8212,2670,6.2352875971,46379,2.6366863355,38654,3376,1020,3.7922729213,30249,2.9486572283,16396,1915,309,11.994758766,16130,2.0516393711,4836,1650
2023-2024,4,08,Abitibi-TÃ©miscamingue,Total rÃ©gional,Total rÃ©gional,,32201,3747,1723,6.0284436042,27313,2.7187572361,25925,2098,1211,4.699865038,21103,3.0009386896,6276,674,95,11.516556945,6210,1.7598401324,1649,512
2023-2024,4,01,Bas-Saint-Laurent,Total rÃ©gional,Total rÃ©gional,,39435,6957,1604,4.4103761534,34320,1.8641345183,29391,3519,939,3.1909050484,24436,2.0362881495,10044,276,8,7.9788225143,9884,1.438522809,3438,665
2023-2024,4,03,Capitale-Nationale,Total rÃ©gional,Total rÃ©gional,,111075,18928,6175,7.2071149699,92018,1.8863703508,72969,7293,2195,3.6179669487,54131,2.3492820555,38106,5940,1289,14.079957618,37887,1.2249858791,11635,3980
2023-2024,4,12,ChaudiÃ¨re-Appalaches,Total rÃ©gional,Total rÃ©gional,,68795,11053,3004,5.5245589392,60161,1.6620005208,53197,5435,1568,3.1959446909,44579,1.9572679961,15598,2494,315,13.466300968,15582,0.817261156,5618,1436
2023-2024,4,09,CÃ´te-Nord,Total rÃ©gional,Total rÃ©gional,,29119,3425,1562,5.9848664007,23263,2.5886556382,22929,2004,1011,3.7175962391,17213,2.7135198687,6190,1069,348,14.383289266,6050,2.2334014233,1421,551
2023-2024,4,05,Estrie,Total rÃ©gional,Total rÃ©gional,,69086,11271,3792,8.5770943381,56950,3.2368633548,45055,4208,1263,5.244929956,33056,4.1579855145,24031,4709,967,14.824469239,23894,1.9625428513,7063,2529
2023-2024,4,11,GaspÃ©sie-Ãles-de-la-Madeleine,Total rÃ©gional,Total rÃ©gional,,28864,4731,1190,5.2949778367,25888,1.7745397696,23128,2864,787,3.3243737869,20221,1.9075954041,5736,932,219,13.240607276,5667,1.2997704057,1867,403
2023-2024,4,14,LanaudiÃ¨re,Total rÃ©gional,Total rÃ©gional,,42930,7708,2688,10.234663127,30736,4.0043394011,28265,2555,1433,6.1533641135,16160,5.0346851966,14665,4275,517,18.100869512,14576,2.8620240845,5153,1255
2023-2024,4,15,Laurentides,Total rÃ©gional,Total rÃ©gional,,55786,9907,3820,11.451045448,42227,3.8977121536,36278,3676,1153,6.3966766283,22896,4.8976170146,19508,6104,1718,20.8503889,19331,2.7134060289,6231,2667
2023-2024,4,13,Laval,Total rÃ©gional,Total rÃ©gional,,27068,5273,1731,9.1599121862,20941,2.7609818591,17345,1689,410,5.1288289132,11239,3.5173074166,9723,1886,196,16.351019804,9702,1.8848384926,3584,1321
2023-2024,4,04,Mauricie et Centre-du-QuÃ©bec,Total rÃ©gional,Total rÃ©gional,,69625,12090,3504,7.1835740076,54968,2.8699119892,45508,4126,1083,4.3420535645,31256,3.5157189375,24117,3324,208,12.5454313,23712,2.0186408195,7964,2421
2023-2024,4,06,MontrÃ©al,Total rÃ©gional,Total rÃ©gional,,253674,36353,18558,10.832771293,210117,2.6326974363,155896,10247,6348,5.637153421,113610,3.4000459491,97778,25858,7550,19.116598369,96507,1.7293591858,26106,12210
2023-2024,4,16,MontÃ©rÃ©gie,Total rÃ©gional,Total rÃ©gional,,111055,20586,6732,10.752300849,82247,3.5573428818,71656,7457,2606,5.7705568387,43121,4.2088165666,39399,11312,3428,19.812730019,39126,2.8393498143,13129,4126
2023-2024,4,07,Outaouais,Total rÃ©gional,Total rÃ©gional,,45945,6112,2526,9.6700113481,33955,3.2422422078,34238,2998,1114,4.804789537,22501,3.2229052659,11707,3523,1759,23.898717624,11454,3.2802289836,3114,1412
2023-2024,4,02,Saguenay-Lac-Saint-Jean,Total rÃ©gional,Total rÃ©gional,,52506,8275,2681,6.0011340238,45129,2.6192885641,35752,3576,1051,3.7451236217,28669,2.9370027537,16754,1413,106,10.815320719,16460,2.0659138315,4699,1630
2024-2025,4,08,Abitibi-TÃ©miscamingue,Total rÃ©gional,Total rÃ©gional,,39027,4697,2103,5.998661468,32931,3.0383339913,31714,2597,1531,4.8541716242,25699,3.3462079804,7313,745,84,10.961925642,7232,1.9443000246,2100,572
2024-2025,4,01,Bas-Saint-Laurent,Total rÃ©gional,Total rÃ©gional,,48012,8199,1875,4.5843240984,41535,2.0053767572,36828,4178,1152,3.2679040102,30510,2.196364416,11184,584,51,8.9191881011,11025,1.4768476442,4021,723
2024-2025,4,03,Capitale-Nationale,Total rÃ©gional,Total rÃ©gional,,130914,22549,7252,7.1368956041,108197,2.0281900813,86718,8720,2587,3.7875194404,64340,2.5000491788,44196,7095,1037,13.708784512,43857,1.3359536233,13829,4665
2024-2025,4,12,ChaudiÃ¨re-Appalaches,Total rÃ©gional,Total rÃ©gional,,79857,13386,3347,6.1900758509,69001,2.0431176521,62402,6814,1686,3.579607874,51575,2.4080920612,17455,3294,876,15.522554951,17426,0.9629182288,6572,1661
2024-2025,4,09,CÃ´te-Nord,Total rÃ©gional,Total rÃ©gional,,34664,4237,1889,6.3529692188,27477,3.1767907098,27551,2507,1141,4.5083286652,20540,3.3733230282,7113,1042,328,13.497871776,6937,2.5948714622,1730,748
2024-2025,4,05,Estrie,Total rÃ©gional,Total rÃ©gional,,79259,13126,4010,8.55816623,64538,3.7518531158,52317,4926,1448,5.8959616696,37810,4.8371984116,26942,4318,553,13.727736269,26728,2.2165004656,8200,2562
2024-2025,4,11,GaspÃ©sie-Ãles-de-la-Madeleine,Total rÃ©gional,Total rÃ©gional,,34274,5870,1295,4.8873759507,30108,2.0235790229,27536,3689,814,3.5147433763,23470,2.1815516617,6738,633,76,10.496875886,6638,1.4650346071,2181,481
2024-2025,4,14,LanaudiÃ¨re,Total rÃ©gional,Total rÃ©gional,,49136,9137,3136,9.7819773294,36664,3.5010597589,32150,2934,1643,5.7078830223,19759,4.3787109812,16986,4689,432,17.493159007,16905,2.4752383746,6203,1493
2024-2025,4,15,Laurentides,Total rÃ©gional,Total rÃ©gional,,65383,11792,4354,11.613705538,50419,3.7074450714,42345,4279,1411,6.1506590703,27547,4.6350453467,23038,7259,2318,21.655059069,22872,2.5902447923,7513,2943
2024-2025,4,13,Laval,Total rÃ©gional,Total rÃ©gional,,30184,5850,2007,10.09892928,23626,3.6052236119,18820,1816,416,6.2666569695,12305,4.6793531085,11364,2398,160,16.445582297,11321,2.4377328024,4034,1591
2024-2025,4,04,Mauricie et Centre-du-QuÃ©bec,Total rÃ©gional,Total rÃ©gional,,82091,14761,4139,7.0530554168,65043,3.1102426045,53292,5258,1216,4.7567657122,36756,3.8783359633,28799,2740,130,11.302295701,28287,2.1121855642,9503,2923
2024-2025,4,06,MontrÃ©al,Total rÃ©gional,Total rÃ©gional,,293985,42982,20828,10.354572188,240148,2.6768309647,179920,11913,7103,5.4698721299,127394,3.4669488163,114065,28501,7308,18.059435507,112754,1.7841240666,31069,13725
2024-2025,4,16,MontÃ©rÃ©gie,Total rÃ©gional,Total rÃ©gional,,123820,23728,8035,11.136639768,90234,3.9422195809,77155,8363,2966,5.9725028046,44078,4.8163748418,46665,13497,3987,19.674923009,46156,3.1074198672,15365,5069
2024-2025,4,07,Outaouais,Total rÃ©gional,Total rÃ©gional,,53120,7638,3139,9.3243689341,40118,3.9542512574,38822,3510,1347,5.3389604906,26312,3.8227184365,14298,4010,1210,20.145569563,13806,4.2049315113,4128,1792
2024-2025,4,02,Saguenay-Lac-Saint-Jean,Total rÃ©gional,Total rÃ©gional,,61332,10031,2924,6.2183019558,52128,2.8934083836,42328,4420,1084,4.082161099,33455,3.2810325479,19004,1622,90,10.976172414,18673,2.1989315232,5611,1840
2020-2021,4,01,Bas-Saint-Laurent,CISSS DU BAS-SAINT-LAURENT,Total Ã©tablissement,,27720,5035,1282,3.7025689935,24064,1.1970534362,19602,2223,737,2.374988394,16021,1.3191725444,8118,59,0,6.908190441,8043,0.953802133,2812,545
2020-2021,4,02,Saguenay-Lac-Saint-Jean,CIUSSS DU SAGUENAY - LAC-SAINT-JEAN,Total Ã©tablissement,,40245,6271,2075,5.0228939482,35517,1.6159536044,26077,2433,690,2.7178640394,21477,1.8128187906,14168,744,31,9.2654309987,14040,1.3148087607,3838,1385
2020-2021,4,03,Capitale-Nationale,CHU DE QUÃBEC - UNIVERSITÃ LAVAL,Total Ã©tablissement,,54865,9072,4768,8.3675165305,48438,1.405978605,31013,2504,1303,3.5540050857,24642,1.8339768823,23852,4065,804,14.626171169,23796,0.96276405,6568,3465
2020-2021,4,03,Capitale-Nationale,CIUSSS DE LA CAPITALE-NATIONALE,Total Ã©tablissement,,22343,2733,540,3.0414546316,17756,1.1733346474,18152,1580,338,2.0877025641,13602,1.2914450081,4191,99,2,7.1723321138,4154,0.7865900337,1153,202
2020-2021,4,03,Capitale-Nationale,INSTITUT UNIVERSITAIRE DE CARDIOLOGIE ET DE PNEUMOLOGIE DE QUÃBEC - UNIVERSITÃ LAVAL,Total Ã©tablissement,,6513,1869,175,7.2176627514,6224,1.4202460011,3283,576,101,3.6041763969,2997,1.8172436325,3230,200,0,10.890441606,3227,1.0515438316,1293,74
2020-2021,4,04,Mauricie et Centre-du-QuÃ©bec,CIUSSS DE LA MAURICIE-ET-DU-CENTRE-DU-QUÃBEC,Total Ã©tablissement,,52540,8862,3307,5.8476148067,43668,1.6879096567,32518,2628,1134,2.9294234048,23842,2.0561745612,20022,1718,53,10.587088786,19826,1.2450481691,6234,2173
2020-2021,4,05,Estrie,CIUSSS DE L'ESTRIE - CENTRE HOSPITALIER UNIVERSITAIRE DE SHERBROOKE,Total Ã©tablissement,,52561,8088,3241,6.5299079271,45567,1.8592790409,31829,2433,1034,3.493257145,24931,2.2925393196,20732,2115,297,11.191954895,20636,1.3358436847,5655,2207
2020-2021,4,06,MontrÃ©al,CENTRE HOSPITALIER DE L'UNIVERSITÃ DE MONTRÃAL,Total Ã©tablissement,,14666,1996,1166,11.56861988,12991,1.9027449559,8655,562,451,5.3937467103,7005,2.4812270997,6011,2058,338,20.459574345,5986,1.2257874856,1434,715
2020-2021,4,06,MontrÃ©al,CENTRE HOSPITALIER UNIVERSITAIRE SAINTE-JUSTINE,Total Ã©tablissement,,11560,0,313,3.9068132209,11129,0.9330511127,7507,0,143,3.1076234033,7123,1.0487483816,4053,5,0,5.3870791869,4006,0.7273317801,0,170
2020-2021,4,06,MontrÃ©al,CENTRE UNIVERSITAIRE DE SANTÃ MCGILL,Total Ã©tablissement,,30103,3487,1761,9.6737457046,28128,1.4098035469,14589,670,385,4.4834924715,12752,1.7490061472,15514,2745,759,14.554537532,15376,1.1284877587,2817,1376
2020-2021,4,06,MontrÃ©al,CIUSSS DE L'EST-DE-L'ÃLE-DE-MONTRÃAL,Total Ã©tablissement,,25129,5187,2845,12.876291381,22201,2.1490627674,13467,1105,1010,4.5548881835,10583,2.9025154336,11662,4225,1335,22.485649712,11618,1.4627321111,4082,1835
2020-2021,4,06,MontrÃ©al,CIUSSS DE L'OUEST-DE-L'ÃLE-DE-MONTRÃAL,Total Ã©tablissement,,24838,4077,2857,10.064960567,23631,1.6551910743,15559,1097,923,4.4124252665,14373,1.8775715075,9279,2627,593,19.543115188,9258,1.3099465327,2980,1934
2020-2021,4,06,MontrÃ©al,CIUSSS DU CENTRE-OUEST-DE-L'ÃLE-DE-MONTRÃAL,Total Ã©tablissement,,16225,3163,889,7.6529086115,15450,0.9843734268,6255,341,98,2.9813917755,5565,1.0610032944,9970,852,103,10.583734871,9885,0.9412327882,2822,791
2020-2021,4,06,MontrÃ©al,CIUSSS DU CENTRE-SUD-DE-L'ÃLE-DE-MONTRÃAL,Total Ã©tablissement,,18218,2318,2253,10.386789698,16380,1.3898005698,9225,529,672,3.7910840108,7849,1.8008219377,8993,2437,619,17.152650364,8531,1.0116377851,1789,1581
2020-2021,4,06,MontrÃ©al,CIUSSS DU NORD-DE-L'ÃLE-DE-MONTRÃAL,Total Ã©tablissement,,29075,4375,2795,8.9539792109,25931,1.6884106432,19352,1268,1237,4.1629999196,16229,2.1424968677,9723,2638,560,18.489619573,9702,0.9288388706,3107,1558
2020-2021,4,06,MontrÃ©al,INSTITUT DE CARDIOLOGIE DE MONTRÃAL,Total Ã©tablissement,,4659,1170,181,8.5912201593,4572,1.0344499125,2976,536,160,3.0629155466,2890,1.1215885236,1683,495,66,18.36676058,1682,0.8847289933,634,21
2020-2021,4,07,Outaouais,CISSS DE L'OUTAOUAIS,Total Ã©tablissement,,35611,4944,2280,6.6570504978,27087,2.1071110475,24785,2095,964,3.279511667,16421,2.1042652024,10826,1910,387,14.389574045,10666,2.111492411,2849,1316
2020-2021,4,08,Abitibi-TÃ©miscamingue,CISSS DE L'ABITIBI-TÃMISCAMINGUE,Total Ã©tablissement,,23566,2979,1467,4.4096645473,20532,1.6063206485,18837,1630,1084,3.0774266957,15816,1.7496196538,4729,330,25,9.7163603416,4716,1.1257402695,1349,383
2020-2021,4,09,CÃ´te-Nord,CISSS DE LA CÃTE-NORD,Total Ã©tablissement,,20369,2434,1125,5.4095947,16841,1.6621599239,15509,1257,644,2.779881807,12196,1.7071555109,4860,701,299,13.801408951,4645,1.5440186581,1177,481
2020-2021,4,11,GaspÃ©sie-Ãles-de-la-Madeleine,CISSS DE LA GASPÃSIE,Total Ã©tablissement,,16913,2843,756,4.4092066753,15386,1.114743562,12836,1496,516,2.4376220958,11383,1.1927616231,4077,391,122,10.616530605,4003,0.8928900547,1347,240
2020-2021,4,11,GaspÃ©sie-Ãles-de-la-Madeleine,CISSS DES ÃLES,Total Ã©tablissement,,2751,325,70,3.4025664405,2381,0.6563472397,2201,190,38,1.6647222222,1835,0.6917482592,550,39,2,10.35710303,546,0.5373712861,135,32
2020-2021,4,12,ChaudiÃ¨re-Appalaches,CISSS DE CHAUDIÃRE-APPALACHES,Total Ã©tablissement,,42018,7345,2123,5.264515459,36147,0.8440456792,28797,2677,945,2.2962168609,22942,1.003549676,13221,1283,33,11.729842948,13205,0.5669278682,4668,1178
2020-2021,4,13,Laval,CISSS DE LAVAL,Total Ã©tablissement,,20050,3639,1446,8.1864555556,16219,1.8921542978,12519,964,416,3.885914277,8705,2.4475194971,7531,1382,110,15.335370211,7514,1.2487614231,2675,1030
2020-2021,4,14,LanaudiÃ¨re,CISSS DE LANAUDIÃRE,Total Ã©tablissement,,32082,4993,2194,8.2308632826,26437,1.8882578919,19405,1345,995,3.9376659652,13865,2.3750161077,12677,2398,243,14.802567467,12572,1.3514377629,3648,1199
2020-2021,4,15,Laurentides,CISSS DES LAURENTIDES,Total Ã©tablissement,,44775,6711,3180,9.3565711521,37009,2.5006747458,27314,2214,1091,4.6488517285,19678,3.1090299517,17461,3603,919,16.720791319,17331,1.8099348149,4497,2089
2020-2021,4,16,MontÃ©rÃ©gie,CISSS DE LA MONTÃRÃGIE-CENTRE,Total Ã©tablissement,,30628,5307,2590,9.1431755982,25346,1.8730404315,19110,1473,884,3.6908503256,13856,2.2535139611,11518,3263,599,18.189358613,11490,1.4142204816,3834,1706
2020-2021,4,16,MontÃ©rÃ©gie,CISSS DE LA MONTÃRÃGIE-EST,Total Ã©tablissement,,32168,5598,2066,8.5175725013,27176,1.8383271187,20106,1901,756,3.8016135316,15149,2.2285545984,12062,2832,552,16.378546722,12027,1.346803373,3697,1310
2020-2021,4,16,MontÃ©rÃ©gie,CISSS DE LA MONTÃRÃGIE-OUEST,Total Ã©tablissement,,24033,4206,1530,10.181636037,21167,1.9288872485,15617,1231,798,4.2594923979,12777,2.2644347482,8416,2498,784,21.170956049,8390,1.4178872004,2975,732
2021-2022,4,01,Bas-Saint-Laurent,CISSS DU BAS-SAINT-LAURENT,Total Ã©tablissement,,35903,5952,1588,3.9980348052,31418,1.6052899789,26719,2925,962,2.8555379859,22343,1.7828535534,9184,140,0,7.3218994084,9075,1.16812161,3027,626
2021-2022,4,02,Saguenay-Lac-Saint-Jean,CIUSSS DU SAGUENAY - LAC-SAINT-JEAN,Total Ã©tablissement,,47721,7272,2385,5.76231432,41112,2.2083257862,31993,3001,856,3.3278752557,25615,2.4789516885,15728,1366,113,10.714311331,15497,1.7610080804,4271,1529
2021-2022,4,03,Capitale-Nationale,CHU DE QUÃBEC - UNIVERSITÃ LAVAL,Total Ã©tablissement,,69624,10666,5312,8.3358707127,58595,1.8698467588,42255,3286,1561,4.186258924,31304,2.5414455377,27369,5046,807,14.74245649,27291,1.0994928629,7380,3751
2021-2022,4,03,Capitale-Nationale,CIUSSS DE LA CAPITALE-NATIONALE,Total Ã©tablissement,,25846,3480,617,3.6981737127,20794,1.7086341413,21487,2116,380,2.7966177353,16477,1.9096644481,4359,162,11,8.1422510897,4317,0.941347515,1364,237
2021-2022,4,03,Capitale-Nationale,INSTITUT UNIVERSITAIRE DE CARDIOLOGIE ET DE PNEUMOLOGIE DE QUÃBEC - UNIVERSITÃ LAVAL,Total Ã©tablissement,,8040,2347,198,7.493533893,7664,1.7237988576,4287,840,127,3.9092275095,3916,2.1188556917,3753,300,0,11.587837508,3748,1.311034033,1507,71
2021-2022,4,04,Mauricie et Centre-du-QuÃ©bec,CIUSSS DE LA MAURICIE-ET-DU-CENTRE-DU-QUÃBEC,Total Ã©tablissement,,69801,11305,3857,6.4592433609,55364,2.6082268662,46010,3809,1370,3.994288319,31931,3.1552680867,23791,2412,61,11.226280538,23433,1.8628006207,7496,2487
2021-2022,4,05,Estrie,CIUSSS DE L'ESTRIE - CENTRE HOSPITALIER UNIVERSITAIRE DE SHERBROOKE,Total Ã©tablissement,,66086,10050,3652,7.5949218317,54950,2.7130159488,41921,3354,1289,4.5876823668,30941,3.4551995105,24165,3405,547,12.81182585,24009,1.7565453927,6696,2363
2021-2022,4,06,MontrÃ©al,CENTRE HOSPITALIER DE L'UNIVERSITÃ DE MONTRÃAL,Total Ã©tablissement,,18209,2737,1405,12.809837016,15279,2.6895632895,10810,778,476,6.5080660911,7930,3.7961766148,7399,2644,596,22.016776291,7349,1.4954629126,1959,929
2021-2022,4,06,MontrÃ©al,CENTRE HOSPITALIER UNIVERSITAIRE SAINTE-JUSTINE,Total Ã©tablissement,,24554,1,730,5.1906394296,21781,1.9370570681,17657,1,375,4.5673057428,15101,2.21223955,6897,60,0,6.7864351248,6680,1.3149716401,0,355
2021-2022,4,06,MontrÃ©al,CENTRE UNIVERSITAIRE DE SANTÃ MCGILL,Total Ã©tablissement,,49925,4514,2493,9.7059235242,43639,2.4477010943,32694,1167,715,5.6344215809,26543,2.9236539347,17231,3649,1313,17.431167824,17096,1.7087436632,3347,1778
2021-2022,4,06,MontrÃ©al,CIUSSS DE L'EST-DE-L'ÃLE-DE-MONTRÃAL,Total Ã©tablissement,,30243,5731,3367,13.019509473,23784,3.4558237914,17385,1308,1209,5.9365849231,11048,4.7396975571,12858,4633,1448,22.596165509,12736,2.3421116869,4423,2158
2021-2022,4,06,MontrÃ©al,CIUSSS DE L'OUEST-DE-L'ÃLE-DE-MONTRÃAL,Total Ã©tablissement,,31138,5203,3449,11.079288178,27206,2.7111131021,20689,1684,1391,6.0536937234,16785,3.3094739847,10449,3166,994,21.029955578,10421,1.7473392402,3519,2058
2021-2022,4,06,MontrÃ©al,CIUSSS DU CENTRE-OUEST-DE-L'ÃLE-DE-MONTRÃAL,Total Ã©tablissement,,25263,4261,1287,8.8806114234,23097,1.8738634046,10756,619,184,4.0499103343,8829,2.1640094197,14507,1844,362,12.462263103,14268,1.6943218313,3642,1103
2021-2022,4,06,MontrÃ©al,CIUSSS DU CENTRE-SUD-DE-L'ÃLE-DE-MONTRÃAL,Total Ã©tablissement,,21627,3022,2428,11.102399393,18954,2.1837778305,14014,892,973,4.8843699951,11374,2.7881789364,7613,2795,719,22.548539414,7580,1.2768572266,2130,1455
2021-2022,4,06,MontrÃ©al,CIUSSS DU NORD-DE-L'ÃLE-DE-MONTRÃAL,Total Ã©tablissement,,39086,6079,3129,9.6062407682,32136,2.6876324925,27047,2017,1430,5.3057278174,20125,3.5219768254,12039,3657,732,19.267838391,12011,1.2896490023,4062,1699
2021-2022,4,06,MontrÃ©al,INSTITUT DE CARDIOLOGIE DE MONTRÃAL,Total Ã©tablissement,,5245,1442,162,9.4661357907,5086,1.4794089986,3161,579,137,3.4830661886,3004,1.6997823273,2084,637,57,18.541223608,2082,1.1614447913,863,25
2021-2022,4,07,Outaouais,CISSS DE L'OUTAOUAIS,Total Ã©tablissement,,39465,5210,2571,8.0406910061,30449,2.2913716287,28440,2341,1133,3.7896617636,19612,2.2732637189,11025,2635,1063,19.006611338,10837,2.3241419827,2869,1438
2021-2022,4,08,Abitibi-TÃ©miscamingue,CISSS DE L'ABITIBI-TÃMISCAMINGUE,Total Ã©tablissement,,31062,3470,1985,5.6042906392,25848,2.4866622391,25291,1971,1456,4.1846928749,20117,2.7460206404,5771,714,108,11.825577601,5731,1.5762603967,1499,529
2021-2022,4,09,CÃ´te-Nord,CISSS DE LA CÃTE-NORD,Total Ã©tablissement,,27059,3131,1527,6.0707117472,21705,2.2776747933,20901,1678,881,3.4561719535,15698,2.3722934981,6158,1089,426,14.94477739,6007,2.0304091985,1453,646
2021-2022,4,11,GaspÃ©sie-Ãles-de-la-Madeleine,CISSS DE LA GASPÃSIE,Total Ã©tablissement,,22157,3728,918,4.764778713,19693,1.5910569746,17609,2213,664,2.9961931399,15221,1.6956431903,4548,541,107,11.612409179,4472,1.2350849732,1515,254
2021-2022,4,11,GaspÃ©sie-Ãles-de-la-Madeleine,CISSS DES ÃLES,Total Ã©tablissement,,3901,473,114,3.3972896551,3392,0.7994792486,3114,283,53,2.033254924,2609,0.8554908224,787,38,1,8.7944995059,783,0.6128455371,190,61
2021-2022,4,12,ChaudiÃ¨re-Appalaches,CISSS DE CHAUDIÃRE-APPALACHES,Total Ã©tablissement,,54230,9058,2796,5.9620789436,46906,1.2695861581,38509,3664,1291,2.876142756,31198,1.5155401343,15721,2344,178,13.521160214,15708,0.7810916235,5394,1505
2021-2022,4,13,Laval,CISSS DE LAVAL,Total Ã©tablissement,,26760,4467,1670,8.3012162224,20848,2.8899156594,17738,1413,523,5.0047934128,11851,3.7026548861,9022,1440,74,14.782256767,8997,1.8193618552,3054,1147
2021-2022,4,14,LanaudiÃ¨re,CISSS DE LANAUDIÃRE,Total Ã©tablissement,,41839,6706,2668,10.033437131,32017,3.3366049547,27345,2131,1408,5.997825674,17609,4.2953297398,14494,4174,480,17.647194222,14408,2.1648819714,4575,1260
2021-2022,4,15,Laurentides,CISSS DES LAURENTIDES,Total Ã©tablissement,,54885,8557,3597,11.739520624,41903,3.6974762282,36341,3121,1290,6.279401984,23484,4.6506953789,18544,6319,2154,22.439810286,18419,2.4821334552,5436,2307
2021-2022,4,16,MontÃ©rÃ©gie,CISSS DE LA MONTÃRÃGIE-CENTRE,Total Ã©tablissement,,40547,6384,3038,9.2642270356,27594,3.3108948604,28451,2371,1337,4.9300741528,15512,3.9680755401,12096,3647,771,19.458587458,12082,2.4671449263,4013,1701
2021-2022,4,16,MontÃ©rÃ©gie,CISSS DE LA MONTÃRÃGIE-EST,Total Ã©tablissement,,41215,7056,2374,9.2793261623,32206,2.9133928633,25131,2406,856,4.5426301182,16251,3.4805429922,16084,3894,968,16.680340107,15955,2.3357208642,4650,1518
2021-2022,4,16,MontÃ©rÃ©gie,CISSS DE LA MONTÃRÃGIE-OUEST,Total Ã©tablissement,,28425,4843,1686,12.434474563,23079,2.5861096187,18860,1496,806,5.5990159803,13570,3.2294539425,9565,3340,1387,25.912440989,9509,1.6680128183,3347,880
2022-2023,4,01,Bas-Saint-Laurent,CISSS DU BAS-SAINT-LAURENT,Total Ã©tablissement,,42005,6475,1428,4.2091247801,36084,1.839392467,31818,3105,891,3.0417297512,26043,2.011791279,10187,256,15,7.8553577272,10041,1.3922475351,3370,537
2022-2023,4,02,Saguenay-Lac-Saint-Jean,CIUSSS DU SAGUENAY - LAC-SAINT-JEAN,Total Ã©tablissement,,55050,8212,2670,6.2352875971,46379,2.6366863355,38654,3376,1020,3.7922729213,30249,2.9486572283,16396,1915,309,11.994758766,16130,2.0516393711,4836,1650
2022-2023,4,03,Capitale-Nationale,CHU DE QUÃBEC - UNIVERSITÃ LAVAL,Total Ã©tablissement,,70514,11452,5342,9.0308923484,58108,1.9623070642,42174,3580,1694,4.2090974297,29851,2.6324928162,28340,5813,1506,16.206417363,28257,1.2543155973,7872,3648
2022-2023,4,03,Capitale-Nationale,CIUSSS DE LA CAPITALE-NATIONALE,Total Ã©tablissement,,37924,4300,680,3.7447102245,27970,1.9067944921,32190,2710,438,2.9030737548,22354,2.1131164569,5734,315,50,8.4695581425,5616,1.0855478395,1590,242
2022-2023,4,03,Capitale-Nationale,INSTITUT UNIVERSITAIRE DE CARDIOLOGIE ET DE PNEUMOLOGIE DE QUÃBEC - UNIVERSITÃ LAVAL,Total Ã©tablissement,,8259,2603,180,8.2668684667,7751,2.0260652747,4220,855,82,4.0244720906,3724,2.5218149541,4039,431,0,12.699379659,4027,1.5676168502,1748,98
2022-2023,4,04,Mauricie et Centre-du-QuÃ©bec,CIUSSS DE LA MAURICIE-ET-DU-CENTRE-DU-QUÃBEC,Total Ã©tablissement,,74373,11836,3863,7.5801108377,56604,3.2598258663,50056,3978,1188,4.8369944551,32656,4.0686501375,24317,3596,363,13.226754488,23948,2.1568959598,7858,2675
2022-2023,4,05,Estrie,CIUSSS DE L'ESTRIE - CENTRE HOSPITALIER UNIVERSITAIRE DE SHERBROOKE,Total Ã©tablissement,,71581,10829,3759,8.3426408893,57974,3.112067076,46878,3689,1250,5.030586878,33397,4.0014109551,24703,4666,1088,14.627807385,24577,1.9035624771,7140,2509
2022-2023,4,06,MontrÃ©al,CENTRE HOSPITALIER DE L'UNIVERSITÃ DE MONTRÃAL,Total Ã©tablissement,,19938,2764,1631,14.295835632,15362,3.2727710151,12243,785,644,7.6950053092,7738,5.0526366991,7695,3124,1016,24.797975417,7624,1.4662913898,1979,987
2022-2023,4,06,MontrÃ©al,CENTRE HOSPITALIER UNIVERSITAIRE SAINTE-JUSTINE,Total Ã©tablissement,,28741,0,619,5.8812887803,22458,2.9420741557,19674,0,298,5.2603055076,14001,3.4887690959,9067,114,2,7.2287272833,8457,2.0369924652,0,321
2022-2023,4,06,MontrÃ©al,CENTRE UNIVERSITAIRE DE SANTÃ MCGILL,Total Ã©tablissement,,55175,4311,2432,10.988838907,44643,3.1194194436,38270,1259,713,6.8752455361,27940,3.8625973415,16905,4240,1876,20.301303756,16703,1.8762660899,3052,1719
2022-2023,4,06,MontrÃ©al,CIUSSS DE L'EST-DE-L'ÃLE-DE-MONTRÃAL,Total Ã©tablissement,,32543,6540,3265,13.467440856,24213,3.3428019039,19107,1665,1060,5.5997610823,10975,4.6183662111,13436,4953,2069,24.655871746,13238,2.2852918366,4875,2205
2022-2023,4,06,MontrÃ©al,CIUSSS DE L'OUEST-DE-L'ÃLE-DE-MONTRÃAL,Total Ã©tablissement,,31605,5723,3393,11.622448628,26571,2.6678498384,21585,1880,1345,5.9771833707,16602,3.2630872619,10020,3250,1251,23.78343172,9969,1.6765636807,3843,2048
2022-2023,4,06,MontrÃ©al,CIUSSS DU CENTRE-OUEST-DE-L'ÃLE-DE-MONTRÃAL,Total Ã©tablissement,,26678,4958,1488,10.129324298,23326,2.4346662523,10454,703,174,4.2940555184,7592,2.9488776563,16224,2396,642,13.88930333,15734,2.1865479747,4255,1314
2022-2023,4,06,MontrÃ©al,CIUSSS DU CENTRE-SUD-DE-L'ÃLE-DE-MONTRÃAL,Total Ã©tablissement,,23457,3369,2293,10.630295505,20436,2.1777851178,15223,863,860,4.8010777734,12229,2.8369737009,8234,2656,652,21.407339655,8207,1.1955483463,2506,1433
2022-2023,4,06,MontrÃ©al,CIUSSS DU NORD-DE-L'ÃLE-DE-MONTRÃAL,Total Ã©tablissement,,42043,6583,3214,10.767342826,32475,3.277449166,29745,2185,1496,6.1010357203,20228,4.3675816388,12298,4457,1215,22.053674333,12247,1.4769102864,4398,1718
2022-2023,4,06,MontrÃ©al,INSTITUT DE CARDIOLOGIE DE MONTRÃAL,Total Ã©tablissement,,5358,1498,166,9.9881793061,5224,1.2666774077,3259,596,139,3.574715233,3129,1.4715389191,2099,710,102,19.946006564,2095,0.9607052506,902,27
2022-2023,4,07,Outaouais,CISSS DE L'OUTAOUAIS,Total Ã©tablissement,,47392,5994,2744,8.1150327118,35666,2.7146616837,35414,2861,1248,4.1369131715,23897,2.7513978393,11978,3096,1420,19.876689533,11769,2.6400687777,3133,1496
2022-2023,4,08,Abitibi-TÃ©miscamingue,CISSS DE L'ABITIBI-TÃMISCAMINGUE,Total Ã©tablissement,,34224,3659,1856,5.9164838921,28233,2.9160538102,28405,2039,1349,4.6336856285,22447,3.2011071759,5819,731,98,12.178364744,5786,1.810178784,1620,507
2022-2023,4,09,CÃ´te-Nord,CISSS DE LA CÃTE-NORD,Total Ã©tablissement,,31417,3382,1490,6.5731675438,24778,2.859682458,25045,1881,964,4.4895591158,18579,2.9940423327,6372,1078,435,14.762742729,6199,2.4569929738,1501,526
2022-2023,4,11,GaspÃ©sie-Ãles-de-la-Madeleine,CISSS DE LA GASPÃSIE,Total Ã©tablissement,,24692,4141,1067,5.6151260192,21691,1.8831226085,19976,2507,736,3.3871787951,17086,2.0119560524,4716,858,310,15.052249376,4605,1.405109965,1634,331
2022-2023,4,11,GaspÃ©sie-Ãles-de-la-Madeleine,CISSS DES ÃLES,Total Ã©tablissement,,5448,615,148,4.4810349364,4768,2.0394405994,4656,416,87,3.4643596077,3983,2.1574517393,792,63,1,10.457853535,785,1.4406656051,199,61
2022-2023,4,12,ChaudiÃ¨re-Appalaches,CISSS DE CHAUDIÃRE-APPALACHES,Total Ã©tablissement,,73326,11054,2960,6.0142100877,62286,1.745382202,56705,5022,1481,3.3259235713,45684,2.0447820839,16621,3479,541,15.185697177,16602,0.9215185587,6032,1479
2022-2023,4,13,Laval,CISSS DE LAVAL,Total Ã©tablissement,,28821,4788,1795,8.7517344799,21357,3.1129045252,19510,1435,564,5.3394210804,12077,3.9861801128,9311,1851,111,15.901797247,9280,1.9764229227,3353,1231
2022-2023,4,14,LanaudiÃ¨re,CISSS DE LANAUDIÃRE,Total Ã©tablissement,,44284,7358,2666,10.216644455,31385,3.7201019861,30205,2384,1464,6.0167476871,17367,4.6877632067,14079,4412,792,19.227077148,14018,2.5212596107,4974,1202
2022-2023,4,15,Laurentides,CISSS DES LAURENTIDES,Total Ã©tablissement,,57495,9051,3732,12.040593351,42025,3.8470417146,38920,3318,1288,6.173850855,23596,4.7327393885,18575,6831,2656,24.333116525,18429,2.7130180392,5733,2444
2022-2023,4,16,MontÃ©rÃ©gie,CISSS DE LA MONTÃRÃGIE-CENTRE,Total Ã©tablissement,,42274,6613,2976,10.145834457,26233,4.0969867682,30345,2468,1222,5.5757423244,14342,4.6986409574,11929,3779,1145,21.771238578,11891,3.3713182472,4145,1754
2022-2023,4,16,MontÃ©rÃ©gie,CISSS DE LA MONTÃRÃGIE-EST,Total Ã©tablissement,,41796,7505,2437,11.428600624,31279,3.8858363883,26554,2694,922,5.4970352343,16163,4.6117365966,15242,4641,1910,21.762335524,15116,3.1096571697,4811,1515
2022-2023,4,16,MontÃ©rÃ©gie,CISSS DE LA MONTÃRÃGIE-OUEST,Total Ã©tablissement,,29425,5069,1493,12.981563816,22679,2.398259501,20641,1711,706,5.5367371036,13921,2.9575729912,8784,3665,1887,30.475720028,8758,1.5092205539,3358,787
2023-2024,4,01,Bas-Saint-Laurent,CISSS DU BAS-SAINT-LAURENT,Total Ã©tablissement,,39435,6957,1604,4.4103761534,34320,1.8641345183,29391,3519,939,3.1909050484,24436,2.0362881495,10044,276,8,7.9788225143,9884,1.438522809,3438,665
2023-2024,4,02,Saguenay-Lac-Saint-Jean,CIUSSS DU SAGUENAY - LAC-SAINT-JEAN,Total Ã©tablissement,,52506,8275,2681,6.0011340238,45129,2.6192885641,35752,3576,1051,3.7451236217,28669,2.9370027537,16754,1413,106,10.815320719,16460,2.0659138315,4699,1630
2023-2024,4,03,Capitale-Nationale,CHU DE QUÃBEC - UNIVERSITÃ LAVAL,Total Ã©tablissement,,68042,11804,5294,8.8264123221,57472,1.9253207359,39645,3584,1655,4.1696657838,29209,2.5925160529,28397,5116,1181,15.327687686,28263,1.235793509,8220,3639
2023-2024,4,03,Capitale-Nationale,CIUSSS DE LA CAPITALE-NATIONALE,Total Ã©tablissement,,34629,4283,690,3.8575945338,26588,1.7868514932,28940,2697,421,2.8105638966,20974,1.9834844199,5689,402,106,9.183849876,5614,1.0522275165,1586,269
2023-2024,4,03,Capitale-Nationale,INSTITUT UNIVERSITAIRE DE CARDIOLOGIE ET DE PNEUMOLOGIE DE QUÃBEC - UNIVERSITÃ LAVAL,Total Ã©tablissement,,8404,2841,191,7.8984896412,7958,1.9375705091,4384,1012,119,3.9587844688,3948,2.4930555556,4020,422,2,12.194924337,4010,1.3906740094,1829,72
2023-2024,4,04,Mauricie et Centre-du-QuÃ©bec,CIUSSS DE LA MAURICIE-ET-DU-CENTRE-DU-QUÃBEC,Total Ã©tablissement,,69625,12090,3504,7.1835740076,54968,2.8699119892,45508,4126,1083,4.3420535645,31256,3.5157189375,24117,3324,208,12.5454313,23712,2.0186408195,7964,2421
2023-2024,4,05,Estrie,CIUSSS DE L'ESTRIE - CENTRE HOSPITALIER UNIVERSITAIRE DE SHERBROOKE,Total Ã©tablissement,,69086,11271,3792,8.5770943381,56950,3.2368633548,45055,4208,1263,5.244929956,33056,4.1579855145,24031,4709,967,14.824469239,23894,1.9625428513,7063,2529
2023-2024,4,06,MontrÃ©al,CENTRE HOSPITALIER DE L'UNIVERSITÃ DE MONTRÃAL,Total Ã©tablissement,,21286,3057,1663,12.496204991,16245,2.9962580794,12386,809,514,7.2831363143,7413,4.915733059,8900,2835,450,19.751156523,8832,1.3851770079,2248,1149
2023-2024,4,06,MontrÃ©al,CENTRE HOSPITALIER UNIVERSITAIRE SAINTE-JUSTINE,Total Ã©tablissement,,23557,0,547,5.2167313325,20335,2.0987922438,15028,0,214,4.4746336283,12111,2.6614739585,8529,116,0,6.5242989604,8224,1.2701640524,0,333
2023-2024,4,06,MontrÃ©al,CENTRE UNIVERSITAIRE DE SANTÃ MCGILL,Total Ã©tablissement,,49755,4178,2375,11.166569089,42576,2.5760929345,33355,1277,691,5.9257364463,26395,2.9611008082,16400,4387,1935,21.825591819,16181,1.9480549375,2901,1684
2023-2024,4,06,MontrÃ©al,CIUSSS DE L'EST-DE-L'ÃLE-DE-MONTRÃAL,Total Ã©tablissement,,30974,6063,3162,12.406954847,24391,2.9947581417,18140,1606,1151,5.7626838019,11619,4.1897455078,12834,4198,1348,21.798187259,12772,1.9076489804,4457,2011
2023-2024,4,06,MontrÃ©al,CIUSSS DE L'OUEST-DE-L'ÃLE-DE-MONTRÃAL,Total Ã©tablissement,,30224,5770,3385,12.669048153,25758,2.6053937072,19970,1910,1234,6.1059691343,15539,3.2301546289,10254,3926,1456,25.45085896,10219,1.6553829468,3860,2151
2023-2024,4,06,MontrÃ©al,CIUSSS DU CENTRE-OUEST-DE-L'ÃLE-DE-MONTRÃAL,Total Ã©tablissement,,26330,5114,1455,10.940234639,22617,2.5148945606,9111,616,157,4.0594895669,5914,3.0678103277,17219,2640,697,14.581007527,16703,2.3191247081,4498,1298
2023-2024,4,06,MontrÃ©al,CIUSSS DU CENTRE-SUD-DE-L'ÃLE-DE-MONTRÃAL,Total Ã©tablissement,,23816,3792,2563,10.837571614,20449,2.1706280802,14687,1014,917,4.7393517888,11348,2.8535596091,9129,3070,496,20.648564556,9101,1.3190835256,2778,1646
2023-2024,4,06,MontrÃ©al,CIUSSS DU NORD-DE-L'ÃLE-DE-MONTRÃAL,Total Ã©tablissement,,41890,6727,3265,10.50131214,32080,3.1860422814,29563,2292,1352,5.9574147677,19788,4.2417854536,12327,4232,1137,21.398630062,12292,1.4864778582,4435,1913
2023-2024,4,06,MontrÃ©al,INSTITUT DE CARDIOLOGIE DE MONTRÃAL,Total Ã©tablissement,,5842,1652,143,8.601290749,5666,1.5022845825,3656,723,118,3.9714989819,3483,1.7547582703,2186,454,31,16.344437456,2183,1.0994600957,929,25
2023-2024,4,07,Outaouais,CISSS DE L'OUTAOUAIS,Total Ã©tablissement,,45945,6112,2526,9.6700113481,33955,3.2422422078,34238,2998,1114,4.804789537,22501,3.2229052659,11707,3523,1759,23.898717624,11454,3.2802289836,3114,1412
2023-2024,4,08,Abitibi-TÃ©miscamingue,CISSS DE L'ABITIBI-TÃMISCAMINGUE,Total Ã©tablissement,,32201,3747,1723,6.0284436042,27313,2.7187572361,25925,2098,1211,4.699865038,21103,3.0009386896,6276,674,95,11.516556945,6210,1.7598401324,1649,512
2023-2024,4,09,CÃ´te-Nord,CISSS DE LA CÃTE-NORD,Total Ã©tablissement,,29119,3425,1562,5.9848664007,23263,2.5886556382,22929,2004,1011,3.7175962391,17213,2.7135198687,6190,1069,348,14.383289266,6050,2.2334014233,1421,551
2023-2024,4,11,GaspÃ©sie-Ãles-de-la-Madeleine,CISSS DE LA GASPÃSIE,Total Ã©tablissement,,24055,4076,1051,5.5757168295,21493,1.8833797696,19204,2438,700,3.4416895641,16705,2.0300303801,4851,886,219,14.023842908,4788,1.3717259584,1638,351
2023-2024,4,11,GaspÃ©sie-Ãles-de-la-Madeleine,CISSS DES ÃLES,Total Ã©tablissement,,4809,655,139,3.8906990943,4395,1.2422762609,3924,426,87,2.7502320478,3516,1.3258899791,885,46,0,8.9474139987,879,0.9078213879,229,52
2023-2024,4,12,ChaudiÃ¨re-Appalaches,CISSS DE CHAUDIÃRE-APPALACHES,Total Ã©tablissement,,68795,11053,3004,5.5245589392,60161,1.6620005208,53197,5435,1568,3.1959446909,44579,1.9572679961,15598,2494,315,13.466300968,15582,0.817261156,5618,1436
2023-2024,4,13,Laval,CISSS DE LAVAL,Total Ã©tablissement,,27068,5273,1731,9.1599121862,20941,2.7609818591,17345,1689,410,5.1288289132,11239,3.5173074166,9723,1886,196,16.351019804,9702,1.8848384926,3584,1321
2023-2024,4,14,LanaudiÃ¨re,CISSS DE LANAUDIÃRE,Total Ã©tablissement,,42930,7708,2688,10.234663127,30736,4.0043394011,28265,2555,1433,6.1533641135,16160,5.0346851966,14665,4275,517,18.100869512,14576,2.8620240845,5153,1255
2023-2024,4,15,Laurentides,CISSS DES LAURENTIDES,Total Ã©tablissement,,55786,9907,3820,11.451045448,42227,3.8977121536,36278,3676,1153,6.3966766283,22896,4.8976170146,19508,6104,1718,20.8503889,19331,2.7134060289,6231,2667
2023-2024,4,16,MontÃ©rÃ©gie,CISSS DE LA MONTÃRÃGIE-CENTRE,Total Ã©tablissement,,40291,7046,2783,9.6674133733,26853,4.0349014387,27666,2584,1005,5.6014924556,14294,4.7180479961,12625,3507,784,18.5773356,12559,3.2573795906,4462,1778
2023-2024,4,16,MontÃ©rÃ©gie,CISSS DE LA MONTÃRÃGIE-EST,Total Ã©tablissement,,41618,8066,2277,10.161917453,32119,3.8615080292,24144,2909,872,5.5127975204,14827,4.5200811395,17474,4107,1005,16.585652811,17292,3.2968154831,5157,1405
2023-2024,4,16,MontÃ©rÃ©gie,CISSS DE LA MONTÃRÃGIE-OUEST,Total Ã©tablissement,,29146,5474,1672,13.095050369,23275,2.5866292278,19846,1964,729,6.3198199749,14000,3.3592398611,9300,3698,1639,27.553246326,9275,1.4204244984,3510,943
2024-2025,4,01,Bas-Saint-Laurent,CISSS DU BAS-SAINT-LAURENT,Total Ã©tablissement,,48012,8199,1875,4.5843240984,41535,2.0053767572,36828,4178,1152,3.2679040102,30510,2.196364416,11184,584,51,8.9191881011,11025,1.4768476442,4021,723
2024-2025,4,02,Saguenay-Lac-Saint-Jean,CIUSSS DU SAGUENAY - LAC-SAINT-JEAN,Total Ã©tablissement,,61332,10031,2924,6.2183019558,52128,2.8934083836,42328,4420,1084,4.082161099,33455,3.2810325479,19004,1622,90,10.976172414,18673,2.1989315232,5611,1840
2024-2025,4,03,Capitale-Nationale,CHU DE QUÃBEC - UNIVERSITÃ LAVAL,Total Ã©tablissement,,79307,14087,6224,8.7968488665,67137,2.0904263959,46350,4233,1962,4.3867660913,34388,2.7897524007,32957,6274,989,14.999092294,32749,1.3561009921,9854,4262
2024-2025,4,03,Capitale-Nationale,CIUSSS DE LA CAPITALE-NATIONALE,Total Ã©tablissement,,41690,5139,847,3.783616035,31745,1.8857088255,35228,3328,532,2.945056363,25397,2.0832479777,6462,332,48,8.3550769026,6348,1.0953966254,1811,315
2024-2025,4,03,Capitale-Nationale,INSTITUT UNIVERSITAIRE DE CARDIOLOGIE ET DE PNEUMOLOGIE DE QUÃBEC - UNIVERSITÃ LAVAL,Total Ã©tablissement,,9917,3323,181,7.9589498392,9315,2.0651957715,5140,1159,93,4.1577931799,4555,2.6368627272,4777,489,0,12.048953027,4760,1.5181489262,2164,88
2024-2025,4,04,Mauricie et Centre-du-QuÃ©bec,CIUSSS DE LA MAURICIE-ET-DU-CENTRE-DU-QUÃBEC,Total Ã©tablissement,,82091,14761,4139,7.0530554168,65043,3.1102426045,53292,5258,1216,4.7567657122,36756,3.8783359633,28799,2740,130,11.302295701,28287,2.1121855642,9503,2923
2024-2025,4,05,Estrie,CIUSSS DE L'ESTRIE - CENTRE HOSPITALIER UNIVERSITAIRE DE SHERBROOKE,Total Ã©tablissement,,79259,13126,4010,8.55816623,64538,3.7518531158,52317,4926,1448,5.8959616696,37810,4.8371984116,26942,4318,553,13.727736269,26728,2.2165004656,8200,2562
2024-2025,4,06,MontrÃ©al,CENTRE HOSPITALIER DE L'UNIVERSITÃ DE MONTRÃAL,Total Ã©tablissement,,25648,3741,2069,12.019635373,18758,3.0085917712,15290,1050,682,7.2527458579,8477,4.8920909192,10358,3216,363,19.056296958,10281,1.4555889235,2691,1387
2024-2025,4,06,MontrÃ©al,CENTRE HOSPITALIER UNIVERSITAIRE SAINTE-JUSTINE,Total Ã©tablissement,,25213,1,645,4.4468839377,22490,1.4555345092,16409,0,238,3.5722465991,13861,1.8111545183,8804,70,4,6.0770434209,8629,0.8842923089,1,407
2024-2025,4,06,MontrÃ©al,CENTRE UNIVERSITAIRE DE SANTÃ MCGILL,Total Ã©tablissement,,56915,5181,2704,11.048054169,49058,2.4360075036,37273,1434,716,5.6549714792,29629,2.8623485812,19642,5156,2349,21.282061456,19429,1.7858422976,3747,1988
2024-2025,4,06,MontrÃ©al,CIUSSS DE L'EST-DE-L'ÃLE-DE-MONTRÃAL,Total Ã©tablissement,,36726,7174,3447,11.966901529,27134,3.2758832195,21626,1862,1277,5.2940889824,12142,4.6850911208,15100,5120,1478,21.523606439,14992,2.1345676954,5312,2170
2024-2025,4,06,MontrÃ©al,CIUSSS DE L'OUEST-DE-L'ÃLE-DE-MONTRÃAL,Total Ã©tablissement,,36148,6960,3952,11.140871617,30585,2.9175077471,23308,2202,1501,6.1684386858,17790,3.6959634002,12840,3818,844,20.167154076,12795,1.8351532283,4758,2451
2024-2025,4,06,MontrÃ©al,CIUSSS DU CENTRE-OUEST-DE-L'ÃLE-DE-MONTRÃAL,Total Ã©tablissement,,31516,5861,1654,10.911922533,26913,2.6753141708,10739,636,158,3.8280905009,6742,3.1233143808,20777,3283,975,14.573340072,20171,2.525573582,5225,1496
2024-2025,4,06,MontrÃ©al,CIUSSS DU CENTRE-SUD-DE-L'ÃLE-DE-MONTRÃAL,Total Ã©tablissement,,27135,4317,2712,10.018666083,22773,2.3474475744,17310,1205,1044,5.280170181,12987,3.1723046765,9825,2657,315,18.367100085,9786,1.2527797647,3112,1668
2024-2025,4,06,MontrÃ©al,CIUSSS DU NORD-DE-L'ÃLE-DE-MONTRÃAL,Total Ã©tablissement,,48151,7952,3501,10.131568013,36099,3.3338403188,33688,2629,1360,5.8558738605,21684,4.5048568837,14463,4794,956,20.090745542,14415,1.5723194589,5323,2141
2024-2025,4,06,MontrÃ©al,INSTITUT DE CARDIOLOGIE DE MONTRÃAL,Total Ã©tablissement,,6533,1795,144,7.5113378234,6338,1.6144786298,4277,895,127,3.6950987842,4082,1.8883624585,2256,387,24,14.746291002,2256,1.1189140071,900,17
2024-2025,4,07,Outaouais,CISSS DE L'OUTAOUAIS,Total Ã©tablissement,,53120,7638,3139,9.3243689341,40118,3.9542512574,38822,3510,1347,5.3389604906,26312,3.8227184365,14298,4010,1210,20.145569563,13806,4.2049315113,4128,1792
2024-2025,4,08,Abitibi-TÃ©miscamingue,CISSS DE L'ABITIBI-TÃMISCAMINGUE,Total Ã©tablissement,,39027,4697,2103,5.998661468,32931,3.0383339913,31714,2597,1531,4.8541716242,25699,3.3462079804,7313,745,84,10.961925642,7232,1.9443000246,2100,572
2024-2025,4,09,CÃ´te-Nord,CISSS DE LA CÃTE-NORD,Total Ã©tablissement,,34664,4237,1889,6.3529692188,27477,3.1767907098,27551,2507,1141,4.5083286652,20540,3.3733230282,7113,1042,328,13.497871776,6937,2.5948714622,1730,748
2024-2025,4,11,GaspÃ©sie-Ãles-de-la-Madeleine,CISSS DE LA GASPÃSIE,Total Ã©tablissement,,28696,5030,1131,4.9130221305,25244,2.0307111261,22996,3126,726,3.5264349114,19632,2.1987076938,5700,536,63,10.507050146,5612,1.4430224915,1904,405
2024-2025,4,11,GaspÃ©sie-Ãles-de-la-Madeleine,CISSS DES ÃLES,Total Ã©tablissement,,5578,840,164,4.7554392753,4864,1.9865636422,4540,563,88,3.4555234337,3838,2.0937957414,1038,97,13,10.441005673,1026,1.5854361598,277,76
2024-2025,4,12,ChaudiÃ¨re-Appalaches,CISSS DE CHAUDIÃRE-APPALACHES,Total Ã©tablissement,,79857,13386,3347,6.1900758509,69001,2.0431176521,62402,6814,1686,3.579607874,51575,2.4080920612,17455,3294,876,15.522554951,17426,0.9629182288,6572,1661
2024-2025,4,13,Laval,CISSS DE LAVAL,Total Ã©tablissement,,30184,5850,2007,10.09892928,23626,3.6052236119,18820,1816,416,6.2666569695,12305,4.6793531085,11364,2398,160,16.445582297,11321,2.4377328024,4034,1591
2024-2025,4,14,LanaudiÃ¨re,CISSS DE LANAUDIÃRE,Total Ã©tablissement,,49136,9137,3136,9.7819773294,36664,3.5010597589,32150,2934,1643,5.7078830223,19759,4.3787109812,16986,4689,432,17.493159007,16905,2.4752383746,6203,1493
2024-2025,4,15,Laurentides,CISSS DES LAURENTIDES,Total Ã©tablissement,,65383,11792,4354,11.613705538,50419,3.7074450714,42345,4279,1411,6.1506590703,27547,4.6350453467,23038,7259,2318,21.655059069,22872,2.5902447923,7513,2943
2024-2025,4,16,MontÃ©rÃ©gie,CISSS DE LA MONTÃRÃGIE-CENTRE,Total Ã©tablissement,,44645,8240,3272,10.830776085,28447,4.7887075868,30868,3289,1181,6.180917365,14712,5.8407775776,13777,4783,1142,21.248997685,13735,3.6618016017,4951,2091
2024-2025,4,16,MontÃ©rÃ©gie,CISSS DE LA MONTÃRÃGIE-EST,Total Ã©tablissement,,46071,9476,2656,10.590128732,35293,4.3443854542,25302,3275,891,5.794524313,14753,5.1515826348,20769,4706,1125,16.432412089,20540,3.7646103808,6201,1765
2024-2025,4,16,MontÃ©rÃ©gie,CISSS DE LA MONTÃRÃGIE-OUEST,Total Ã©tablissement,,33104,6012,2107,12.309718371,26494,2.497602518,20985,1799,894,5.8805262092,14613,3.4466127383,12119,4008,1720,23.442369374,11881,1.3303702691,4213,1213
2020-2021,4,01,Bas-Saint-Laurent,CISSS DU BAS-SAINT-LAURENT,CENTRE HOSPITALIER RÃGIONAL DU GRAND-PORTAGE,51218352,4419,879,255,4.3690735083,3647,1.4103633885,2949,292,139,2.4951971478,2184,1.630980235,1470,9,0,8.1282989418,1463,1.0810214931,587,116
2020-2021,4,01,Bas-Saint-Laurent,CISSS DU BAS-SAINT-LAURENT,CENTRE MULTISERVICES DE SANTÃ ET DE SERVICES SOCIAUX DE TROIS-PISTOLES,51236156,1637,235,63,2.455706068,1486,0.8612492523,1354,150,50,1.9282502462,1211,0.9305656482,283,2,0,4.9792932862,275,0.5560050505,85,13
2020-2021,4,01,Bas-Saint-Laurent,CISSS DU BAS-SAINT-LAURENT,CLSC DE POHÃNÃGAMOOK,51219418,1632,277,40,1.3511853214,1356,0.5027661013,1498,230,35,1.0187589008,1224,0.5192565359,134,0,0,5.0674150083,132,0.349854798,47,5
2020-2021,4,01,Bas-Saint-Laurent,CISSS DU BAS-SAINT-LAURENT,HÃPITAL D'AMQUI,51226892,3095,525,114,3.4612915994,2890,0.8977843137,1831,211,65,2.2568402209,1641,0.9589281603,1264,8,0,5.2060308984,1249,0.8174504048,314,49
2020-2021,4,01,Bas-Saint-Laurent,CISSS DU BAS-SAINT-LAURENT,HÃPITAL DE MATANE,51218980,4005,794,192,3.7733471355,3580,1.5269857232,2854,362,98,2.9247781866,2454,1.7633299375,1151,13,0,5.8774442514,1126,1.0118980659,432,94
2020-2021,4,01,Bas-Saint-Laurent,CISSS DU BAS-SAINT-LAURENT,HÃPITAL DE NOTRE-DAME-DU-LAC,51221877,2448,404,79,3.2654134895,2198,0.7506451572,1805,199,40,1.501197907,1559,0.869227425,643,15,0,8.2178382582,639,0.4613341158,205,39
2020-2021,4,01,Bas-Saint-Laurent,CISSS DU BAS-SAINT-LAURENT,HÃPITAL NOTRE-DAME-DE-FATIMA,51221141,3070,530,95,3.5545301303,2818,0.9318482375,2309,253,42,1.9705825032,2059,0.9899684313,761,3,0,8.3604894875,759,0.7741809398,277,53
2020-2021,4,01,Bas-Saint-Laurent,CISSS DU BAS-SAINT-LAURENT,HÃPITAL RÃGIONAL DE RIMOUSKI,51227882,7414,1391,444,4.3663419057,6089,1.537799219,5002,526,268,3.0627560642,3689,1.7662331707,2412,9,0,7.0697151972,2400,1.1866771991,865,176
2020-2021,4,02,Saguenay-Lac-Saint-Jean,CIUSSS DU SAGUENAY - LAC-SAINT-JEAN,HÃPITAL D'ALMA,51219400,7320,1120,315,4.0916819217,6039,1.8905728965,5344,555,115,2.7608592191,4094,2.0252994219,1976,39,2,7.6908299595,1945,1.606989146,565,200
2020-2021,4,02,Saguenay-Lac-Saint-Jean,CIUSSS DU SAGUENAY - LAC-SAINT-JEAN,HÃPITAL DE CHICOUTIMI,51218394,12827,2011,848,6.0461238447,11697,1.2369179419,6653,519,249,2.234626192,5559,1.4224208491,6174,497,14,10.153330499,6138,1.0689135983,1492,599
2020-2021,4,02,Saguenay-Lac-Saint-Jean,CIUSSS DU SAGUENAY - LAC-SAINT-JEAN,HÃPITAL DE DOLBEAU-MISTASSINI,51219384,4375,732,164,4.0548834286,3957,1.331564878,3496,412,64,2.5755053394,3084,1.4466003747,879,74,11,9.9387353053,873,0.9251851852,320,100
2020-2021,4,02,Saguenay-Lac-Saint-Jean,CIUSSS DU SAGUENAY - LAC-SAINT-JEAN,HÃPITAL DE LA BAIE,51221364,3568,508,109,4.2620729011,3299,1.6363406419,2719,249,58,2.8041313187,2457,1.8519072491,849,21,1,8.9312639052,842,1.0073060174,259,51
2020-2021,4,02,Saguenay-Lac-Saint-Jean,CIUSSS DU SAGUENAY - LAC-SAINT-JEAN,HÃPITAL ET CENTRE D'HÃBERGEMENT DE ROBERVAL,51228203,5628,819,350,3.998907743,5094,1.4365959408,3737,316,92,2.3826885797,3216,1.5980983105,1891,47,1,7.1928850109,1878,1.1600295823,503,258
2020-2021,4,02,Saguenay-Lac-Saint-Jean,CIUSSS DU SAGUENAY - LAC-SAINT-JEAN,HÃPITAL ET CENTRE DE RÃADAPTATION DE JONQUIÃRE,51224541,6527,1081,289,6.0040724427,5431,2.4899862927,4128,382,112,3.808196194,3067,2.7988783828,2399,66,2,9.7825539577,2364,2.0892366986,699,177
2020-2021,4,03,Capitale-Nationale,CHU DE QUÃBEC - UNIVERSITÃ LAVAL,CENTRE HOSPITALIER DE L'UNIVERSITÃ LAVAL,51217594,17012,1713,1703,7.26086937,15226,1.4377860604,9530,322,449,3.9099468054,7758,1.9519453038,7482,760,144,11.529018533,7468,0.9036608046,1391,1254
2020-2021,4,03,Capitale-Nationale,CHU DE QUÃBEC - UNIVERSITÃ LAVAL,HÃPITAL DE L'ENFANT-JÃSUS,51233914,16030,2597,2162,9.6770390587,14519,1.3350413443,8709,801,493,3.5357097064,7204,1.7549517244,7321,1569,401,16.982712782,7315,0.9215028101,1796,1669
2020-2021,4,03,Capitale-Nationale,CHU DE QUÃBEC - UNIVERSITÃ LAVAL,HÃPITAL DU SAINT-SACREMENT,51217529,7200,1544,260,6.9303622685,6078,1.2889533289,4971,578,106,2.748270804,3854,1.5339740818,2229,481,98,16.257045387,2224,0.8643535172,966,154
2020-2021,4,03,Capitale-Nationale,CHU DE QUÃBEC - UNIVERSITÃ LAVAL,HÃPITAL SAINT-FRANÃOIS D'ASSISE,51217602,10178,2205,413,9.6357999825,8631,1.5952714054,5744,563,166,3.8317493133,4210,2.1408148588,4434,1099,161,17.154624305,4421,1.0757649727,1642,247
2020-2021,4,03,Capitale-Nationale,CHU DE QUÃBEC - UNIVERSITÃ LAVAL,L'HÃTEL-DIEU DE QUÃBEC,51217586,4445,1013,230,7.3041997875,3984,1.3113830321,2059,240,89,3.1543703794,1616,1.5360320407,2386,156,0,10.885297336,2368,1.1580752628,773,141
2020-2021,4,03,Capitale-Nationale,CIUSSS DE LA CAPITALE-NATIONALE,CENTRE MULTISERVICES DE SANTÃ ET DE SERVICES SOCIAUX CHAUVEAU,51225001,6386,429,122,2.3591998991,5100,1.177688671,5526,358,96,2.058074054,4251,1.2298056666,860,0,0,4.2941085271,849,0.916735375,71,26
2020-2021,4,03,Capitale-Nationale,CIUSSS DE LA CAPITALE-NATIONALE,CENTRE MULTISERVICES DE SANTÃ ET DE SERVICES SOCIAUX DE BAIE-SAINT-PAUL,51244804,2570,497,78,3.6851192175,1878,1.1161489765,1954,275,35,2.1294863812,1269,1.2652863147,616,13,1,8.6197077922,609,0.8053849662,222,43
2020-2021,4,03,Capitale-Nationale,CIUSSS DE LA CAPITALE-NATIONALE,CENTRE MULTISERVICES DE SANTÃ ET DE SERVICES SOCIAUX DE SAINT-MARC-DES-CARRIÃRES,51247344,3097,420,77,2.520044039,2655,0.8878578154,2452,226,42,1.6464088273,2015,1.0181200717,645,7,0,5.841212317,640,0.4777352431,194,35
2020-2021,4,03,Capitale-Nationale,CIUSSS DE LA CAPITALE-NATIONALE,CENTRE MULTISERVICES DE SANTÃ ET DE SERVICES SOCIAUX DE SAINT-RAYMOND,51247302,4158,563,103,3.8395058388,3512,1.7053853455,3164,240,58,2.7457181486,2529,1.9764721453,994,27,0,7.3211398949,983,1.0079504352,323,45
2020-2021,4,03,Capitale-Nationale,CIUSSS DE LA CAPITALE-NATIONALE,CENTRE MULTISERVICES DE SANTÃ ET DE SERVICES SOCIAUX DE SAINTE-ANNE-DE-BEAUPRÃ,51225357,3173,362,62,2.6955206254,2205,0.9716725876,2710,216,47,1.8857149446,1745,1.0255776823,463,15,0,7.4354199664,460,0.7671847826,146,15
2020-2021,4,03,Capitale-Nationale,CIUSSS DE LA CAPITALE-NATIONALE,HÃPITAL ET CLSC DE LA MALBAIE,51228690,2959,462,98,3.7500795126,2406,0.9319518334,2346,265,60,1.9297993038,1793,1.0557946025,613,37,1,10.716437375,613,0.5697167845,197,38
2020-2021,4,03,Capitale-Nationale,INSTITUT UNIVERSITAIRE DE CARDIOLOGIE ET DE PNEUMOLOGIE DE QUÃBEC - UNIVERSITÃ LAVAL,INSTITUT UNIVERSITAIRE DE CARDIOLOGIE ET DE PNEUMOLOGIE DE QUÃBEC,51232130,6513,1869,175,7.2176627514,6224,1.4202460011,3283,576,101,3.6041763969,2997,1.8172436325,3230,200,0,10.890441606,3227,1.0515438316,1293,74
2020-2021,4,04,Mauricie et Centre-du-QuÃ©bec,CIUSSS DE LA MAURICIE-ET-DU-CENTRE-DU-QUÃBEC,CENTRE MULTISERVICES DE SANTÃ ET DE SERVICES SOCIAUX AVELLIN-DALCOURT,51233583,4298,639,141,4.3574185021,3885,2.0238599314,3467,312,91,3.1666298112,3055,2.2680773777,831,29,1,9.3254863618,830,1.1249631861,327,50
2020-2021,4,04,Mauricie et Centre-du-QuÃ©bec,CIUSSS DE LA MAURICIE-ET-DU-CENTRE-DU-QUÃBEC,CENTRE MULTISERVICES DE SANTÃ ET DE SERVICES SOCIAUX CHRIST-ROI,51246338,3844,462,144,3.5875224014,3188,1.5728495748,3107,221,87,2.0155419662,2455,1.6569286038,737,55,5,10.214582391,733,1.2912479157,241,57
2020-2021,4,04,Mauricie et Centre-du-QuÃ©bec,CIUSSS DE LA MAURICIE-ET-DU-CENTRE-DU-QUÃBEC,CENTRE MULTISERVICES DE SANTÃ ET DE SERVICES SOCIAUX DE FORTIERVILLE,51219160,2093,208,59,1.3885517864,1908,0.6374475891,1947,171,54,1.2718241739,1762,0.6618410266,146,0,0,2.9451864536,146,0.3430555556,37,5
2020-2021,4,04,Mauricie et Centre-du-QuÃ©bec,CIUSSS DE LA MAURICIE-ET-DU-CENTRE-DU-QUÃBEC,CENTRE MULTISERVICES DE SANTÃ ET DE SERVICES SOCIAUX DU HAUT-SAINT-MAURICE,51219731,2835,435,142,3.7116475603,2195,1.7087617059,2133,215,83,2.2966107986,1504,1.8214132683,702,20,0,8.0111823362,691,1.4635693037,220,59
2020-2021,4,04,Mauricie et Centre-du-QuÃ©bec,CIUSSS DE LA MAURICIE-ET-DU-CENTRE-DU-QUÃBEC,HÃPITAL DU CENTRE-DE-LA-MAURICIE,51220051,7625,1472,596,5.5757384335,6224,1.5601542416,4122,306,138,2.7647349588,2745,2.0184178304,3503,123,1,8.8834621911,3479,1.1985751812,1166,458
2020-2021,4,04,Mauricie et Centre-du-QuÃ©bec,CIUSSS DE LA MAURICIE-ET-DU-CENTRE-DU-QUÃBEC,HÃPITAL SAINTE-CROIX,51228781,9616,1365,675,6.5513236042,8147,1.8330365301,5819,380,271,3.8656400966,4392,2.2894239526,3797,287,8,10.667202543,3755,1.2992273265,985,404
2020-2021,4,04,Mauricie et Centre-du-QuÃ©bec,CIUSSS DE LA MAURICIE-ET-DU-CENTRE-DU-QUÃBEC,HÃTEL-DIEU D'ARTHABASKA,51228039,8246,1329,462,4.1853920756,6637,1.3021255001,4596,374,118,2.2262964172,3045,1.6067984857,3650,53,0,6.6522423896,3592,1.0438489854,955,344
2020-2021,4,04,Mauricie et Centre-du-QuÃ©bec,CIUSSS DE LA MAURICIE-ET-DU-CENTRE-DU-QUÃBEC,PAVILLON SAINTE-MARIE,51220168,13983,2952,1088,8.6720321104,11484,1.9659840745,7327,649,292,3.6195752392,4884,2.7912776413,6656,1151,38,14.233833717,6600,1.355266835,2303,796
2020-2021,4,05,Estrie,CIUSSS DE L'ESTRIE - CENTRE HOSPITALIER UNIVERSITAIRE DE SHERBROOKE,CENTRE DE SANTÃ ET DE SERVICES SOCIAUX DU GRANIT,51223832,3480,472,138,5.6496599617,3027,2.4486083581,2665,222,77,3.9510782781,2218,2.6733756638,815,84,2,11.20391786,809,1.8323736437,250,61
2020-2021,4,05,Estrie,CIUSSS DE L'ESTRIE - CENTRE HOSPITALIER UNIVERSITAIRE DE SHERBROOKE,CENTRE MULTISERVICES DE SANTÃ ET DE SERVICES SOCIAUX DE LA MRC DE COATICOOK,51247617,2970,253,88,2.6688468013,2648,1.3412617489,2232,130,66,1.8795885603,1918,1.3919693547,738,6,0,5.0558717254,730,1.2080327245,123,22
2020-2021,4,05,Estrie,CIUSSS DE L'ESTRIE - CENTRE HOSPITALIER UNIVERSITAIRE DE SHERBROOKE,CENTRE MULTISERVICES DE SANTÃ ET DE SERVICES SOCIAUX DE MEMPHRÃMAGOG,51219046,5183,984,215,5.7181774819,4290,2.4920959596,3470,365,87,3.5191970861,2625,2.601115873,1713,135,2,10.172621133,1665,2.3202177177,619,128
2020-2021,4,05,Estrie,CIUSSS DE L'ESTRIE - CENTRE HOSPITALIER UNIVERSITAIRE DE SHERBROOKE,CENTRE MULTISERVICES DE SANTÃ ET DE SERVICES SOCIAUX DES SOURCES,51247583,3349,419,133,3.1380880694,2663,1.6301158885,2834,252,88,2.2751078178,2151,1.7375271192,515,18,0,7.8869929881,512,1.1788628472,167,45
2020-2021,4,05,Estrie,CIUSSS DE L'ESTRIE - CENTRE HOSPITALIER UNIVERSITAIRE DE SHERBROOKE,CHUS - HÃPITAL FLEURIMONT,51216687,10488,1607,227,6.4490036232,9561,1.6253041871,5279,281,98,4.0411915135,4353,2.5211731373,5209,209,2,8.8891725859,5208,0.8765104967,1326,129
2020-2021,4,05,Estrie,CIUSSS DE L'ESTRIE - CENTRE HOSPITALIER UNIVERSITAIRE DE SHERBROOKE,CHUS - HÃTEL-DIEU DE SHERBROOKE,51216695,11451,2058,1562,7.8419395686,9992,1.5251968241,4846,423,281,3.252462512,3392,2.0237617925,6605,617,157,11.209177391,6600,1.2689646465,1635,1281
2020-2021,4,05,Estrie,CIUSSS DE L'ESTRIE - CENTRE HOSPITALIER UNIVERSITAIRE DE SHERBROOKE,HÃPITAL BROME-MISSISQUOI-PERKINS,51229185,6214,913,194,7.3886872832,5427,2.0899450791,4262,312,85,3.769289001,3488,2.3331103466,1952,389,77,15.291287426,1939,1.6525234944,601,109
2020-2021,4,05,Estrie,CIUSSS DE L'ESTRIE - CENTRE HOSPITALIER UNIVERSITAIRE DE SHERBROOKE,HÃPITAL DE GRANBY,51228120,9426,1382,684,7.6528670993,7959,2.0862730522,6241,448,252,3.9485905927,4786,2.5101228119,3185,657,57,14.911388191,3173,1.4469585391,934,432
2020-2021,4,06,MontrÃ©al,CENTRE HOSPITALIER DE L'UNIVERSITÃ DE MONTRÃAL,CENTRE HOSPITALIER DE L'UNIVERSITÃ DE MONTRÃAL,51236297,14666,1996,1166,11.56861988,12991,1.9027449559,8655,562,451,5.3937467103,7005,2.4812270997,6011,2058,338,20.459574345,5986,1.2257874856,1434,715
2020-2021,4,06,MontrÃ©al,CENTRE HOSPITALIER UNIVERSITAIRE SAINTE-JUSTINE,CHU SAINTE-JUSTINE,51222800,11560,0,313,3.9068132209,11129,0.9330511127,7507,0,143,3.1076234033,7123,1.0487483816,4053,5,0,5.3870791869,4006,0.7273317801,0,170
2020-2021,4,06,MontrÃ©al,CENTRE UNIVERSITAIRE DE SANTÃ MCGILL,HÃPITAL DE LACHINE,51228310,3762,658,186,9.2981304271,3505,1.7609181328,2055,206,44,3.6385847526,1847,1.9398747218,1707,358,76,16.111467487,1658,1.561561788,452,142
2020-2021,4,06,MontrÃ©al,CENTRE UNIVERSITAIRE DE SANTÃ MCGILL,HÃPITAL GÃNÃRAL DE MONTRÃAL,51248219,6658,1174,887,12.285500234,6184,1.0764490801,1412,88,76,4.0578562716,997,1.5977903154,5246,830,249,14.500031929,5187,0.9762414048,1086,811
2020-2021,4,06,MontrÃ©al,CENTRE UNIVERSITAIRE DE SANTÃ MCGILL,HÃPITAL ROYAL VICTORIA,51223295,10571,1654,352,12.587188561,9442,2.0300938184,6046,376,165,5.6341223307,4934,2.5411780503,4525,1520,432,21.877406998,4508,1.4707128069,1278,187
2020-2021,4,06,MontrÃ©al,CENTRE UNIVERSITAIRE DE SANTÃ MCGILL,L'HÃPITAL DE MONTRÃAL POUR ENFANTS,51223279,9112,1,336,4.5405146449,8997,0.8511758549,5076,0,100,3.573440373,4974,0.9226393915,4036,37,2,5.7567854586,4023,0.7628189991,1,236
2020-2021,4,06,MontrÃ©al,CIUSSS DE L'EST-DE-L'ÃLE-DE-MONTRÃAL,HÃPITAL MAISONNEUVE-ROSEMONT,12934659,15301,3018,1304,12.50744158,13268,1.9881558805,7788,612,307,4.3906587057,5792,2.6595620396,7513,2542,671,20.921324852,7476,1.4679867428,2406,997
2020-2021,4,06,MontrÃ©al,CIUSSS DE L'EST-DE-L'ÃLE-DE-MONTRÃAL,HÃPITAL SANTA CABRINI,51235919,8724,2114,443,13.794325997,7886,2.5400121876,5145,477,174,4.9065273729,4314,3.3928778396,3579,1531,615,26.571002142,3572,1.5099835137,1637,269
2020-2021,4,06,MontrÃ©al,CIUSSS DE L'EST-DE-L'ÃLE-DE-MONTRÃAL,INSTITUT UNIVERSITAIRE EN SANTÃ MENTALE DE MONTRÃAL,51235307,1104,55,1098,10.733933424,1047,1.2435092327,534,16,529,3.5620708489,477,1.4177410901,570,152,49,17.452836257,570,1.0977046784,39,569
2020-2021,4,06,MontrÃ©al,CIUSSS DE L'OUEST-DE-L'ÃLE-DE-MONTRÃAL,CENTRE HOSPITALIER DE ST. MARY,51248243,8492,1528,742,8.3674558408,8278,1.2670830313,5502,462,253,3.8518926956,5292,1.3966249895,2990,671,75,16.676696117,2986,1.0374996279,1066,489
2020-2021,4,06,MontrÃ©al,CIUSSS DE L'OUEST-DE-L'ÃLE-DE-MONTRÃAL,HÃPITAL DE LASALLE,51224392,6346,791,242,7.621924353,5833,2.2470886432,4671,257,93,4.2954345964,4163,2.4990388208,1675,464,26,16.898362355,1670,1.6190236194,534,149
2020-2021,4,06,MontrÃ©al,CIUSSS DE L'OUEST-DE-L'ÃLE-DE-MONTRÃAL,HÃPITAL DOUGLAS,51235190,1408,38,1346,13.503570865,1295,2.3872576148,552,13,499,3.6112696256,439,2.078306125,856,269,45,19.882718393,856,2.5457035306,25,847
2020-2021,4,06,MontrÃ©al,CIUSSS DE L'OUEST-DE-L'ÃLE-DE-MONTRÃAL,HÃPITAL GÃNÃRAL DU LAKESHORE,51228278,8592,1720,527,12.983623817,8225,1.5107769335,4834,365,78,5.2549473061,4479,1.8485199449,3758,1223,447,22.9251944,3746,1.1069459275,1355,449
2020-2021,4,06,MontrÃ©al,CIUSSS DU CENTRE-OUEST-DE-L'ÃLE-DE-MONTRÃAL,HÃPITAL GÃNÃRAL JUIF,51248250,16225,3163,889,7.6529086115,15450,0.9843734268,6255,341,98,2.9813917755,5565,1.0610032944,9970,852,103,10.583734871,9885,0.9412327882,2822,791
2020-2021,4,06,MontrÃ©al,CIUSSS DU CENTRE-SUD-DE-L'ÃLE-DE-MONTRÃAL,HÃPITAL DE VERDUN,51218097,9094,1243,772,9.10673689,8214,1.025490017,4543,306,214,3.105123878,3958,1.3179544944,4551,1119,236,15.097799934,4256,0.7535035505,937,558
2020-2021,4,06,MontrÃ©al,CIUSSS DU CENTRE-SUD-DE-L'ÃLE-DE-MONTRÃAL,HÃPITAL NOTRE-DAME,51236313,9124,1075,1481,11.662633652,8166,1.7562525512,4682,223,458,4.4566792444,3891,2.2920039836,4442,1318,383,19.257923733,4275,1.2686247563,852,1023
2020-2021,4,06,MontrÃ©al,CIUSSS DU NORD-DE-L'ÃLE-DE-MONTRÃAL,HÃPITAL DU SACRÃ-COEUR-DE-MONTRÃAL,12475976,12311,2202,699,9.8246100371,11338,1.3800486809,7630,579,353,4.2750401558,6662,1.8270954668,4681,1251,362,18.870373377,4676,0.7431312969,1623,346
2020-2021,4,06,MontrÃ©al,CIUSSS DU NORD-DE-L'ÃLE-DE-MONTRÃAL,HÃPITAL EN SANTÃ MENTALE ALBERT-PRÃVOST,51848752,879,31,877,16.046213184,869,0.3363137706,308,8,306,2.9272186147,298,0.5226444817,571,219,55,23.122658591,571,0.2390693715,23,571
2020-2021,4,06,MontrÃ©al,CIUSSS DU NORD-DE-L'ÃLE-DE-MONTRÃAL,HÃPITAL FLEURY,51228492,7235,1061,436,7.7690182754,6243,2.0060447701,5303,401,223,3.7749271901,4317,2.3191790209,1932,569,70,18.732095411,1926,1.3041753202,660,213
2020-2021,4,06,MontrÃ©al,CIUSSS DU NORD-DE-L'ÃLE-DE-MONTRÃAL,HÃPITAL JEAN-TALON,51228500,8650,1081,783,7.9852835581,7481,2.0477463277,6111,280,355,4.4221560847,4952,2.5102640908,2539,599,73,16.561207934,2529,1.1420966785,801,428
2020-2021,4,06,MontrÃ©al,INSTITUT DE CARDIOLOGIE DE MONTRÃAL,INSTITUT DE CARDIOLOGIE DE MONTRÃAL,51248201,4659,1170,181,8.5912201593,4572,1.0344499125,2976,536,160,3.0629155466,2890,1.1215885236,1683,495,66,18.36676058,1682,0.8847289933,634,21
2020-2021,4,07,Outaouais,CISSS DE L'OUTAOUAIS,CENTRE MULTISERVICES DE SANTÃ ET DE SERVICES SOCIAUX DE MANSFIELD-ET-PONTEFRACT,51245058,2149,260,66,3.366020759,1371,1.5905405624,2061,242,66,3.1186182544,1283,1.6094440114,88,4,1,9.1602998737,88,1.3149368687,18,0
2020-2021,4,07,Outaouais,CISSS DE L'OUTAOUAIS,CLSC ET CENTRE D'HÃBERGEMENT DE LA PETITE-NATION,51219491,1970,317,68,2.378213621,1574,0.7060629324,1759,252,62,2.1285397322,1364,0.7350938824,211,0,0,4.4596182201,210,0.5175,65,6
2020-2021,4,07,Outaouais,CISSS DE L'OUTAOUAIS,HÃPITAL DE GATINEAU,51221703,9245,1223,1170,8.5438916832,6579,2.3475786594,5513,391,322,3.2741166334,2905,2.4280827118,3732,807,174,16.328529907,3674,2.2839248019,832,848
2020-2021,4,07,Outaouais,CISSS DE L'OUTAOUAIS,HÃPITAL DE HULL,51221711,8089,1426,348,8.7867804357,5828,2.3066101388,4761,361,204,3.5609127401,2536,2.5836757361,3328,760,152,16.262848975,3292,2.0931719995,1065,144
2020-2021,4,07,Outaouais,CISSS DE L'OUTAOUAIS,HÃPITAL DE MANIWAKI,51221893,3491,468,190,4.8848644133,2972,2.0601627224,2471,220,94,3.3467201763,1978,2.2245489271,1020,58,19,8.6110942266,994,1.7330440979,248,96
2020-2021,4,07,Outaouais,CISSS DE L'OUTAOUAIS,HÃPITAL ET CHSLD DE PAPINEAU,51228823,5204,655,267,6.2287238449,3873,2.6661636113,3636,212,93,3.2190081439,2337,2.6963421766,1568,198,22,13.207886019,1536,2.6202473958,443,174
2020-2021,4,07,Outaouais,CISSS DE L'OUTAOUAIS,HÃPITAL ET CHSLD DU PONTIAC,51219459,2414,302,74,4.3930845531,2180,1.628776631,2091,231,49,3.7392499601,1860,1.6411521804,323,10,0,8.6258032336,320,1.55684375,71,25
2020-2021,4,07,Outaouais,CISSS DE L'OUTAOUAIS,HÃPITAL ET CHSLD MÃMORIAL DE WAKEFIELD / WAKEFIELD MEMORIAL HOSPITAL,51228799,3049,293,97,4.9225233228,2710,1.8066828618,2493,186,74,3.3351711459,2158,1.9122890279,556,73,19,12.039913569,552,1.3938239734,107,23
2020-2021,4,08,Abitibi-TÃ©miscamingue,CISSS DE L'ABITIBI-TÃMISCAMINGUE,CENTRE MULTISERVICES DE SANTÃ ET DE SERVICES SOCIAUX DE LA SARRE,51247559,3829,503,206,3.4168400511,3627,0.9117228809,3268,311,182,2.7708516082,3066,0.9378859535,561,15,0,7.1799242424,561,0.7687353931,192,24
2020-2021,4,08,Abitibi-TÃ©miscamingue,CISSS DE L'ABITIBI-TÃMISCAMINGUE,CENTRE MULTISERVICES DE SANTÃ ET DE SERVICES SOCIAUX DE TÃMISCAMING-KIPAWA,51247476,1087,109,63,2.4891927323,994,0.6227719092,1076,105,62,2.3665037691,983,0.6169424664,11,3,0,14.49040404,11,1.1437121212,4,1
2020-2021,4,08,Abitibi-TÃ©miscamingue,CISSS DE L'ABITIBI-TÃMISCAMINGUE,CENTRE MULTISERVICES DE SANTÃ ET DE SERVICES SOCIAUX DE VILLE-MARIE,51247542,2573,387,165,3.6066849117,2320,1.4440171216,2249,292,125,2.9738692505,1999,1.4785032794,324,2,0,7.9992849794,321,1.2292575286,95,40
2020-2021,4,08,Abitibi-TÃ©miscamingue,CISSS DE L'ABITIBI-TÃMISCAMINGUE,HÃPITAL D'AMOS,51228906,3874,425,196,3.70368432,3300,0.6120564815,2767,153,161,1.6564817492,2194,0.7127432138,1107,72,5,8.8207660845,1106,0.4123216797,272,35
2020-2021,4,08,Abitibi-TÃ©miscamingue,CISSS DE L'ABITIBI-TÃMISCAMINGUE,HÃPITAL DE ROUYN-NORANDA,51228922,5583,808,316,4.9573147651,4702,2.0773719812,4307,397,194,3.7567148441,3431,2.3086556398,1276,52,2,9.009809953,1271,1.4530334819,411,122
2020-2021,4,08,Abitibi-TÃ©miscamingue,CISSS DE L'ABITIBI-TÃMISCAMINGUE,HÃPITAL DE VAL-D'OR,51225589,6620,747,521,5.5626223565,5589,2.4901435359,5170,372,360,3.6588196862,4143,2.8360336713,1450,186,18,12.350663602,1446,1.4991180652,375,161
2020-2021,4,09,CÃ´te-Nord,CISSS DE LA CÃTE-NORD,CENTRE MULTISERVICES DE SANTÃ ET DE SERVICES SOCIAUX DE FERMONT,51245108,918,0,64,3.8386564996,769,1.1953980639,868,0,59,3.7954249872,719,1.1890797404,50,0,0,4.5891555556,50,1.2862555556,0,5
2020-2021,4,09,CÃ´te-Nord,CISSS DE LA CÃTE-NORD,CENTRE MULTISERVICES DE SANTÃ ET DE SERVICES SOCIAUX DE FORESTVILLE,51218741,2398,311,82,2.3430144333,1892,1.0652036352,1990,211,60,1.7277956449,1560,1.1326787749,408,2,1,5.3437139161,332,0.7481517738,100,22
2020-2021,4,09,CÃ´te-Nord,CISSS DE LA CÃTE-NORD,CENTRE MULTISERVICES DE SANTÃ ET DE SERVICES SOCIAUX DE LA BASSE-CÃTE-NORD,51245140,712,100,34,3.2730153714,699,1.1462915276,613,76,27,3.0571950335,600,1.1876268519,99,0,0,4.6093574635,99,0.8957744108,24,7
2020-2021,4,09,CÃ´te-Nord,CISSS DE LA CÃTE-NORD,CENTRE MULTISERVICES DE SANTÃ ET DE SERVICES SOCIAUX DE LA MINGANIE,51245116,2310,177,77,2.4345505051,1098,1.3224296701,1734,116,46,1.786816609,633,1.4570471301,576,0,0,4.3844994213,465,1.1391762246,61,31
2020-2021,4,09,CÃ´te-Nord,CISSS DE LA CÃTE-NORD,CENTRE MULTISERVICES DE SANTÃ ET DE SERVICES SOCIAUX DE PORT-CARTIER,51245132,2232,197,96,3.0719611211,2081,0.8551456298,1954,122,75,1.6954772262,1803,0.9002947248,278,35,7,12.746959432,278,0.5623261391,75,21
2020-2021,4,09,CÃ´te-Nord,CISSS DE LA CÃTE-NORD,CENTRE MULTISERVICES DE SANTÃ ET DE SERVICES SOCIAUX DES ESCOUMINS,51218733,2019,350,42,2.6979724561,1889,0.8670437033,1741,227,40,2.0590000957,1611,0.8910240361,278,1,0,6.6995943245,278,0.7280785372,123,2
2020-2021,4,09,CÃ´te-Nord,CISSS DE LA CÃTE-NORD,CLSC ET HÃPITAL LE ROYER,51228765,4863,740,352,9.8294183974,4503,2.4833481383,3417,290,200,4.4158265047,3059,2.8622518252,1446,413,212,22.622117911,1444,1.680670591,450,152
2020-2021,4,09,CÃ´te-Nord,CISSS DE LA CÃTE-NORD,HÃPITAL ET CLSC DE SEPT-ÃLES,51232023,4917,559,378,6.7087889522,3910,2.0983639528,3192,215,137,2.951592523,2211,2.1480574401,1725,250,79,13.66123591,1699,2.0336951475,344,241
2020-2021,4,11,GaspÃ©sie-Ãles-de-la-Madeleine,CISSS DE LA GASPÃSIE,CENTRE MULTISERVICES DE SANTÃ ET DE SERVICES SOCIAUX DE GRANDE-VALLÃE,51247732,1222,204,27,1.7128684761,939,0.6977544078,1065,148,24,1.2054799165,794,0.7217047999,157,2,0,5.1547080679,145,0.566605364,56,3
2020-2021,4,11,GaspÃ©sie-Ãles-de-la-Madeleine,CISSS DE LA GASPÃSIE,CLSC ET CENTRE DE SERVICES AMBULATOIRES DE MURDOCHVILLE,51221307,394,44,23,2.6580647208,370,1.8781771772,393,43,23,2.6579092451,369,1.8819640169,1,0,0,2.7191666667,1,0.4808333333,1,0
2020-2021,4,11,GaspÃ©sie-Ãles-de-la-Madeleine,CISSS DE LA GASPÃSIE,CLSC ET CENTRE DE SERVICES AMBULATOIRES DE PASPÃBIAC,51220978,2606,481,113,3.3034028311,2442,1.1223682774,1864,290,95,2.3939821769,1749,1.203236929,742,21,5,5.5879851752,693,0.9182712041,191,18
2020-2021,4,11,GaspÃ©sie-Ãles-de-la-Madeleine,CISSS DE LA GASPÃSIE,HÃPITAL DE CHANDLER,51227775,3357,551,147,4.1253007811,2993,1.1826520214,2690,305,112,2.6508711276,2330,1.2897690749,667,25,0,10.071651258,663,0.8062074744,246,35
2020-2021,4,11,GaspÃ©sie-Ãles-de-la-Madeleine,CISSS DE LA GASPÃSIE,HÃPITAL DE GASPÃ,51220903,2938,488,150,3.6744722411,2738,0.7905995861,2271,267,113,2.3315498557,2074,0.8647520894,667,11,0,8.2468511578,664,0.5589846888,221,37
2020-2021,4,11,GaspÃ©sie-Ãles-de-la-Madeleine,CISSS DE LA GASPÃSIE,HÃPITAL ET CLSC DE SAINTE-ANNE-DES-MONTS,51247799,2995,456,125,2.9121617511,2809,0.6837353151,2278,229,71,1.5098864745,2095,0.7263236542,717,31,10,7.3673682783,714,0.5587737317,227,54
2020-2021,4,11,GaspÃ©sie-Ãles-de-la-Madeleine,CISSS DE LA GASPÃSIE,HÃPITAL ET GROUPE DE MÃDECINE DE FAMILLE UNIVERSITAIRE DE MARIA,51227908,3401,619,171,8.6614770166,3095,1.7562366721,2275,214,78,3.79482442,1972,1.9700608519,1126,301,107,18.494189856,1123,1.3807591273,405,93
2020-2021,4,11,GaspÃ©sie-Ãles-de-la-Madeleine,CISSS DES ÃLES,HÃPITAL DE L'ARCHIPEL,51227783,2751,325,70,3.4025664405,2381,0.6563472397,2201,190,38,1.6647222222,1835,0.6917482592,550,39,2,10.35710303,546,0.5373712861,135,32
2020-2021,4,12,ChaudiÃ¨re-Appalaches,CISSS DE CHAUDIÃRE-APPALACHES,CHSLD ET HÃPITAL PAUL-GILBERT,51245199,28,1,1,0.8799702381,17,0.3811601307,28,1,1,0.8799702381,17,0.3811601307,0,0,0,,0,,0,0
2020-2021,4,12,ChaudiÃ¨re-Appalaches,CISSS DE CHAUDIÃRE-APPALACHES,HÃPITAL DE MONTMAGNY,51245223,6527,1128,234,4.0221851965,5998,0.8315928921,4633,491,114,1.7875258412,4106,0.9933354982,1894,65,0,9.4884876217,1892,0.4805806613,637,120
2020-2021,4,12,ChaudiÃ¨re-Appalaches,CISSS DE CHAUDIÃRE-APPALACHES,HÃPITAL DE SAINT-GEORGES,51228971,9185,1593,461,5.3627981915,7842,1.3174647199,6038,498,185,2.6724883608,4705,1.5663658637,3147,159,0,10.524568372,3137,0.9441526759,1095,276
2020-2021,4,12,ChaudiÃ¨re-Appalaches,CISSS DE CHAUDIÃRE-APPALACHES,HÃPITAL DE THETFORD,51245231,7889,1401,271,4.7507318911,6608,0.7565783478,5855,667,116,2.4853358478,4575,0.8257887067,2034,162,7,11.271820305,2033,0.6008295076,734,155
2020-2021,4,12,ChaudiÃ¨re-Appalaches,CISSS DE CHAUDIÃRE-APPALACHES,HÃTEL-DIEU DE LÃVIS,51227569,18389,3222,1156,5.8834707343,15682,0.6494271918,12243,1020,529,2.2159425341,9539,0.8167089492,6146,897,26,13.189287161,6143,0.3896680051,2202,627
2020-2021,4,13,Laval,CISSS DE LAVAL,HÃPITAL DE LA CITÃ-DE-LA-SANTÃ,51228757,20050,3639,1446,8.1864555556,16219,1.8921542978,12519,964,416,3.885914277,8705,2.4475194971,7531,1382,110,15.335370211,7514,1.2487614231,2675,1030
2020-2021,4,14,LanaudiÃ¨re,CISSS DE LANAUDIÃRE,HÃPITAL DE LANAUDIÃRE ET CENTRE D'HÃBERGEMENT PARPHILIA-FERLAND,51244945,13982,2236,1066,8.0118710366,12859,1.2003641634,8051,493,652,3.6960624284,6953,1.4559014095,5931,983,83,13.870339272,5906,0.8995259529,1743,414
2020-2021,4,14,LanaudiÃ¨re,CISSS DE LANAUDIÃRE,HÃPITAL PIERRE-LE GARDEUR,51228062,18100,2757,1128,8.400031768,13578,2.5397253727,11354,852,343,4.1089844499,6912,3.2995827305,6746,1415,160,15.622170998,6666,1.7518264743,1905,785
2020-2021,4,15,Laurentides,CISSS DES LAURENTIDES,CENTRE MULTISERVICES DE SANTÃ ET DE SERVICES SOCIAUX D'ARGENTEUIL,51245306,4146,536,211,7.0071118749,3721,2.3799927588,3347,300,122,4.2097163297,2922,2.6051478249,799,237,30,18.725363301,799,1.5565846197,236,89
2020-2021,4,15,Laurentides,CISSS DES LAURENTIDES,CENTRE MULTISERVICES DE SANTÃ ET DE SERVICES SOCIAUX DE RIVIÃRE-ROUGE,51217628,3117,400,184,5.2834489181,2867,1.6646350231,2103,180,68,2.6689645744,1875,1.7403453333,1014,102,21,10.705796625,992,1.5215333781,220,116
2020-2021,4,15,Laurentides,CISSS DES LAURENTIDES,CENTRE MULTISERVICES DE SANTÃ ET DE SERVICES SOCIAUX DE SAINTE-AGATHE,51246874,7540,1114,491,8.449423298,6207,3.2208186098,4963,414,149,5.4472760091,3659,3.9233312836,2577,309,24,14.231207153,2548,2.211990559,700,342
2020-2021,4,15,Laurentides,CISSS DES LAURENTIDES,HÃPITAL DE MONT-LAURIER,51217610,4342,516,192,5.4679648396,3746,1.965083274,3335,266,105,3.473023405,2753,2.0599937442,1007,121,15,12.074846353,993,1.7019528365,250,87
2020-2021,4,15,Laurentides,CISSS DES LAURENTIDES,HÃPITAL DE SAINT-EUSTACHE,51228864,12030,1994,771,9.8884271959,9854,2.2672279165,6552,445,258,4.8896170381,4388,3.2573597184,5478,1105,207,15.867288852,5466,1.4723690897,1549,513
2020-2021,4,15,Laurentides,CISSS DES LAURENTIDES,HÃPITAL DE SAINT-JÃRÃME,51228880,13600,2151,1331,12.280304636,10614,2.753431605,7014,609,389,5.2212501188,4081,3.9167301043,6586,1729,622,19.798101233,6533,2.026748431,1542,942
2020-2021,4,16,MontÃ©rÃ©gie,CISSS DE LA MONTÃRÃGIE-CENTRE,HÃPITAL CHARLES-LE MOYNE,51233799,15954,3098,1516,10.108271454,12466,2.0362942314,9749,896,591,3.817772877,6270,2.434758639,6205,1958,407,19.99160274,6196,1.633070888,2202,925
2020-2021,4,16,MontÃ©rÃ©gie,CISSS DE LA MONTÃRÃGIE-CENTRE,HÃPITAL DU HAUT-RICHELIEU,51229045,14674,2209,1074,8.0938952872,12880,1.7150340752,9361,577,293,3.5586670168,7586,2.1037111492,5313,1305,192,16.084535573,5294,1.1580820006,1632,781
2020-2021,4,16,MontÃ©rÃ©gie,CISSS DE LA MONTÃRÃGIE-EST,HÃPITAL HONORÃ-MERCIER,51229193,11140,1892,767,7.8253282715,9260,1.8617938565,7985,750,373,3.6486512906,6109,2.219138657,3155,919,138,18.396093943,3151,1.1689917663,1142,394
2020-2021,4,16,MontÃ©rÃ©gie,CISSS DE LA MONTÃRÃGIE-EST,HÃPITAL PIERRE-BOUCHER,51229011,13186,2437,880,10.474632396,10890,2.1932943067,7609,755,297,4.2864845724,5332,2.6261200717,5577,1615,396,18.917454127,5558,1.77806815,1682,583
2020-2021,4,16,MontÃ©rÃ©gie,CISSS DE LA MONTÃRÃGIE-EST,HÃTEL-DIEU DE SOREL,51229102,7842,1269,419,6.2102285769,7026,1.2572148686,4512,396,86,3.2546320922,3708,1.6723795397,3330,298,18,10.214928679,3318,0.7932514567,873,333
2020-2021,4,16,MontÃ©rÃ©gie,CISSS DE LA MONTÃRÃGIE-OUEST,HÃPITAL ANNA-LABERGE,51229151,10563,1862,677,10.221455395,9147,2.1321298422,6625,524,198,5.2510968553,5213,2.6705463904,3938,1078,150,18.583219062,3934,1.4186663277,1338,479
2020-2021,4,16,MontÃ©rÃ©gie,CISSS DE LA MONTÃRÃGIE-OUEST,HÃPITAL BARRIE MEMORIAL / BARRIE MEMORIAL HOSPITAL,51228005,3994,421,105,4.6682499444,3546,1.930821113,3314,240,90,2.7221463656,2870,1.5683343012,680,127,10,14.152642974,676,3.4697813938,181,15
2020-2021,4,16,MontÃ©rÃ©gie,CISSS DE LA MONTÃRÃGIE-OUEST,HÃPITAL DU SUROÃT,51229136,9476,1923,748,12.461063242,8474,1.7086940117,5678,467,510,3.9997856738,4694,2.2390296123,3798,1293,624,25.110650927,3780,1.0501238242,1456,238
2021-2022,4,01,Bas-Saint-Laurent,CISSS DU BAS-SAINT-LAURENT,CENTRE HOSPITALIER RÃGIONAL DU GRAND-PORTAGE,51218352,5525,981,268,5.0457057315,4649,1.9935921106,3909,390,158,3.0319506978,3037,2.2750021037,1616,47,0,9.91684956,1612,1.4634170802,591,110
2021-2022,4,01,Bas-Saint-Laurent,CISSS DU BAS-SAINT-LAURENT,CENTRE MULTISERVICES DE SANTÃ ET DE SERVICES SOCIAUX DE TROIS-PISTOLES,51236156,2531,446,89,3.3612396286,2309,1.4031788653,2186,291,79,2.6471720291,1969,1.5096794763,345,14,0,7.8857375201,340,0.7864150327,155,10
2021-2022,4,01,Bas-Saint-Laurent,CISSS DU BAS-SAINT-LAURENT,CLSC DE POHÃNÃGAMOOK,51219418,2256,296,69,1.3485282457,1964,0.5590334352,2133,261,66,1.1013782101,1842,0.5700010556,123,0,0,5.6344715447,122,0.3934403461,35,3
2021-2022,4,01,Bas-Saint-Laurent,CISSS DU BAS-SAINT-LAURENT,HÃPITAL D'AMQUI,51226892,4091,633,151,3.307741723,3734,1.3300749866,2431,238,89,2.6006446821,2122,1.5187458111,1660,1,0,4.3432555221,1612,1.0817130204,395,62
2021-2022,4,01,Bas-Saint-Laurent,CISSS DU BAS-SAINT-LAURENT,HÃPITAL DE MATANE,51218980,4917,799,223,4.1345685038,4360,2.1233761468,3785,437,129,3.6348212241,3245,2.4005552131,1132,6,0,5.8055432862,1115,1.3166980568,362,94
2021-2022,4,01,Bas-Saint-Laurent,CISSS DU BAS-SAINT-LAURENT,HÃPITAL DE NOTRE-DAME-DU-LAC,51221877,3369,583,93,3.4444024768,3046,1.0258053367,2553,325,44,2.0011803107,2239,1.1840628257,816,23,0,7.9597777097,807,0.5867241498,258,49
2021-2022,4,01,Bas-Saint-Laurent,CISSS DU BAS-SAINT-LAURENT,HÃPITAL NOTRE-DAME-DE-FATIMA,51221141,3943,659,141,3.5805154,3693,1.2726947378,3128,344,80,2.5648112035,2885,1.3476679184,815,2,0,7.4788254942,808,1.0049996562,315,61
2021-2022,4,01,Bas-Saint-Laurent,CISSS DU BAS-SAINT-LAURENT,HÃPITAL RÃGIONAL DE RIMOUSKI,51227882,9271,1555,554,4.8032071334,7663,1.9287256224,6594,639,317,3.5028143851,5004,2.2683644751,2677,47,0,8.0063411572,2659,1.2895557018,916,237
2021-2022,4,02,Saguenay-Lac-Saint-Jean,CIUSSS DU SAGUENAY - LAC-SAINT-JEAN,HÃPITAL D'ALMA,51219400,8938,1333,345,4.3775435718,7106,2.0024327251,6693,700,143,2.9059247223,4902,2.1423979441,2245,91,7,8.7648687206,2204,1.6911307723,633,202
2021-2022,4,02,Saguenay-Lac-Saint-Jean,CIUSSS DU SAGUENAY - LAC-SAINT-JEAN,HÃPITAL DE CHICOUTIMI,51218394,14949,2294,911,7.1174615916,13049,1.9633323328,8391,658,266,3.163379911,6560,2.4967191734,6558,871,90,12.176732617,6489,1.4241093903,1636,645
2021-2022,4,02,Saguenay-Lac-Saint-Jean,CIUSSS DU SAGUENAY - LAC-SAINT-JEAN,HÃPITAL DE DOLBEAU-MISTASSINI,51219384,5304,832,234,4.0392383631,4880,1.7360950592,4323,507,119,2.9621738376,3908,1.8712546202,981,55,3,8.7855685808,972,1.1926757545,325,115
2021-2022,4,02,Saguenay-Lac-Saint-Jean,CIUSSS DU SAGUENAY - LAC-SAINT-JEAN,HÃPITAL DE LA BAIE,51221364,4473,624,150,4.7898833122,3989,2.195527353,3486,333,93,3.3655422484,3018,2.4534553788,987,60,6,9.8205347293,971,1.3938519854,291,57
2021-2022,4,02,Saguenay-Lac-Saint-Jean,CIUSSS DU SAGUENAY - LAC-SAINT-JEAN,HÃPITAL ET CENTRE D'HÃBERGEMENT DE ROBERVAL,51228203,6649,916,428,5.3892267008,5990,2.2971570673,4392,341,130,3.5146342466,3773,2.5129266425,2257,111,2,9.0370822872,2217,1.9299497569,575,298
2021-2022,4,02,Saguenay-Lac-Saint-Jean,CIUSSS DU SAGUENAY - LAC-SAINT-JEAN,HÃPITAL ET CENTRE DE RÃADAPTATION DE JONQUIÃRE,51224541,7408,1273,317,6.8541775408,6098,3.2715326063,4708,462,105,4.3545893515,3454,3.5955910217,2700,178,5,11.212718724,2644,2.8481975962,811,212
2021-2022,4,03,Capitale-Nationale,CHU DE QUÃBEC - UNIVERSITÃ LAVAL,CENTRE HOSPITALIER DE L'UNIVERSITÃ LAVAL,51217594,22947,1919,2169,7.5432344097,18687,1.8834236368,13522,385,643,4.5942364501,9294,2.7914703034,9425,1025,182,11.77414692,9393,0.9849475673,1534,1526
2021-2022,4,03,Capitale-Nationale,CHU DE QUÃBEC - UNIVERSITÃ LAVAL,HÃPITAL DE L'ENFANT-JÃSUS,51233914,18401,2751,2169,9.1259273349,16332,1.6448621656,10656,881,473,4.0881960085,8592,2.231535149,7745,1654,296,16.057117137,7740,0.9936096756,1870,1696
2021-2022,4,03,Capitale-Nationale,CHU DE QUÃBEC - UNIVERSITÃ LAVAL,HÃPITAL DU SAINT-SACREMENT,51217529,10369,2112,293,7.4776532077,8491,2.0986938785,7583,872,139,3.7074889739,5713,2.5438446914,2786,755,143,17.739374452,2778,1.1832343413,1240,154
2021-2022,4,03,Capitale-Nationale,CHU DE QUÃBEC - UNIVERSITÃ LAVAL,HÃPITAL SAINT-FRANÃOIS D'ASSISE,51217602,12487,2515,426,9.2361992027,10113,2.1212807772,7760,786,192,4.2928389891,5401,2.8829725462,4727,1224,162,17.351383306,4712,1.2482126014,1729,234
2021-2022,4,03,Capitale-Nationale,CHU DE QUÃBEC - UNIVERSITÃ LAVAL,L'HÃTEL-DIEU DE QUÃBEC,51217586,5420,1369,255,8.5770605269,4972,1.6556158934,2734,362,114,3.576067829,2304,1.8820384838,2686,388,24,13.667423161,2668,1.4600845411,1007,141
2021-2022,4,03,Capitale-Nationale,CIUSSS DE LA CAPITALE-NATIONALE,CENTRE MULTISERVICES DE SANTÃ ET DE SERVICES SOCIAUX CHAUVEAU,51225001,4316,334,61,3.3175036042,3290,1.931393617,4006,298,51,3.2008833278,2983,2.0158736544,310,0,0,4.8245385305,307,1.11053384,36,10
2021-2022,4,03,Capitale-Nationale,CIUSSS DE LA CAPITALE-NATIONALE,CENTRE MULTISERVICES DE SANTÃ ET DE SERVICES SOCIAUX DE BAIE-SAINT-PAUL,51244804,3198,577,97,3.9767768049,2630,1.4753377693,2448,335,39,2.484814134,1882,1.6802625753,750,23,0,8.846542963,748,0.9597381907,242,58
2021-2022,4,03,Capitale-Nationale,CIUSSS DE LA CAPITALE-NATIONALE,CENTRE MULTISERVICES DE SANTÃ ET DE SERVICES SOCIAUX DE SAINT-MARC-DES-CARRIÃRES,51247344,4291,625,127,3.0064564075,3596,1.4211165184,3492,341,84,2.3218753977,2810,1.6306896006,799,12,0,5.998392435,786,0.6718794176,284,43
2021-2022,4,03,Capitale-Nationale,CIUSSS DE LA CAPITALE-NATIONALE,CENTRE MULTISERVICES DE SANTÃ ET DE SERVICES SOCIAUX DE SAINT-RAYMOND,51247302,5777,788,115,3.9854177005,4659,2.2113850731,4640,448,74,3.1368641044,3535,2.5432241867,1137,27,2,7.448292534,1124,1.1677451562,340,41
2021-2022,4,03,Capitale-Nationale,CIUSSS DE LA CAPITALE-NATIONALE,CENTRE MULTISERVICES DE SANTÃ ET DE SERVICES SOCIAUX DE SAINTE-ANNE-DE-BEAUPRÃ,51225357,4473,483,81,3.2152890181,3424,1.4608180004,3881,307,55,2.4935319505,2840,1.5618804773,592,20,3,7.9469430368,584,0.9693497907,176,26
2021-2022,4,03,Capitale-Nationale,CIUSSS DE LA CAPITALE-NATIONALE,HÃPITAL ET CLSC DE LA MALBAIE,51228690,3791,673,136,4.8115193148,3195,1.5273540254,3020,387,77,2.9287833885,2427,1.7641779975,771,80,6,12.186178844,768,0.7789532697,286,59
2021-2022,4,03,Capitale-Nationale,INSTITUT UNIVERSITAIRE DE CARDIOLOGIE ET DE PNEUMOLOGIE DE QUÃBEC - UNIVERSITÃ LAVAL,INSTITUT UNIVERSITAIRE DE CARDIOLOGIE ET DE PNEUMOLOGIE DE QUÃBEC,51232130,8040,2347,198,7.493533893,7664,1.7237988576,4287,840,127,3.9092275095,3916,2.1188556917,3753,300,0,11.587837508,3748,1.311034033,1507,71
2021-2022,4,04,Mauricie et Centre-du-QuÃ©bec,CIUSSS DE LA MAURICIE-ET-DU-CENTRE-DU-QUÃBEC,CENTRE MULTISERVICES DE SANTÃ ET DE SERVICES SOCIAUX AVELLIN-DALCOURT,51233583,6143,832,163,4.8574361966,5296,2.885125042,5152,472,120,4.1470445674,4310,3.2413502191,991,19,0,8.5506124566,986,1.3279947036,360,43
2021-2022,4,04,Mauricie et Centre-du-QuÃ©bec,CIUSSS DE LA MAURICIE-ET-DU-CENTRE-DU-QUÃBEC,CENTRE MULTISERVICES DE SANTÃ ET DE SERVICES SOCIAUX CHRIST-ROI,51246338,5837,627,185,4.354336084,4730,2.8085840968,4900,311,108,3.3833015873,3805,2.9908369835,937,55,2,9.432317977,925,2.0588843844,316,77
2021-2022,4,04,Mauricie et Centre-du-QuÃ©bec,CIUSSS DE LA MAURICIE-ET-DU-CENTRE-DU-QUÃBEC,CENTRE MULTISERVICES DE SANTÃ ET DE SERVICES SOCIAUX DE FORTIERVILLE,51219160,3621,320,73,1.8193823069,3111,1.1443011358,3335,280,65,1.6932450441,2826,1.1792020524,286,0,0,3.2902486402,285,0.7982309942,40,8
2021-2022,4,04,Mauricie et Centre-du-QuÃ©bec,CIUSSS DE LA MAURICIE-ET-DU-CENTRE-DU-QUÃBEC,CENTRE MULTISERVICES DE SANTÃ ET DE SERVICES SOCIAUX DU HAUT-SAINT-MAURICE,51219731,3423,542,188,4.7091379394,3013,2.4158761109,2547,291,95,3.6586376129,2159,2.6401722763,876,15,1,7.7635036149,854,1.8488322925,251,93
2021-2022,4,04,Mauricie et Centre-du-QuÃ©bec,CIUSSS DE LA MAURICIE-ET-DU-CENTRE-DU-QUÃBEC,HÃPITAL DU CENTRE-DE-LA-MAURICIE,51220051,10274,1884,700,5.8169523122,8087,2.2689493082,6109,512,147,3.5990953693,3966,3.0393238359,4165,138,0,9.0699866613,4121,1.5275502845,1372,553
2021-2022,4,04,Mauricie et Centre-du-QuÃ©bec,CIUSSS DE LA MAURICIE-ET-DU-CENTRE-DU-QUÃBEC,HÃPITAL SAINTE-CROIX,51228781,12258,1734,786,7.2461803856,9530,2.8966931911,7789,530,340,4.9012777992,5160,3.5418120155,4469,424,1,11.333100557,4370,2.1349510552,1204,446
2021-2022,4,04,Mauricie et Centre-du-QuÃ©bec,CIUSSS DE LA MAURICIE-ET-DU-CENTRE-DU-QUÃBEC,HÃTEL-DIEU D'ARTHABASKA,51228039,10219,1719,622,5.671015456,8071,2.1436120748,5977,546,131,3.3243305356,3917,2.6155664057,4242,221,3,8.9775066792,4154,1.6985843631,1173,491
2021-2022,4,04,Mauricie et Centre-du-QuÃ©bec,CIUSSS DE LA MAURICIE-ET-DU-CENTRE-DU-QUÃBEC,PAVILLON SAINTE-MARIE,51220168,18026,3647,1140,9.2288715682,13526,3.0861392462,10201,867,364,4.983382212,5788,4.4563013515,7825,1540,54,14.763470536,7738,2.0612622412,2780,776
2021-2022,4,05,Estrie,CIUSSS DE L'ESTRIE - CENTRE HOSPITALIER UNIVERSITAIRE DE SHERBROOKE,CENTRE DE SANTÃ ET DE SERVICES SOCIAUX DU GRANIT,51223832,3983,652,146,6.2079225598,3454,3.189151869,3107,347,99,4.7733469227,2585,3.5016919192,876,66,3,11.29608067,869,2.2594441248,305,47
2021-2022,4,05,Estrie,CIUSSS DE L'ESTRIE - CENTRE HOSPITALIER UNIVERSITAIRE DE SHERBROOKE,CENTRE MULTISERVICES DE SANTÃ ET DE SERVICES SOCIAUX DE LA MRC DE COATICOOK,51247617,4335,420,118,3.346651288,3593,2.1235662708,3315,209,79,2.63192182,2612,2.1636464182,1020,24,3,5.6695220588,981,2.0168493034,211,39
2021-2022,4,05,Estrie,CIUSSS DE L'ESTRIE - CENTRE HOSPITALIER UNIVERSITAIRE DE SHERBROOKE,CENTRE MULTISERVICES DE SANTÃ ET DE SERVICES SOCIAUX DE MEMPHRÃMAGOG,51219046,6339,1257,230,6.1375210338,5248,2.5888634824,4394,518,105,3.7673421459,3346,2.8683544199,1945,238,29,11.492053699,1902,2.09718279,739,125
2021-2022,4,05,Estrie,CIUSSS DE L'ESTRIE - CENTRE HOSPITALIER UNIVERSITAIRE DE SHERBROOKE,CENTRE MULTISERVICES DE SANTÃ ET DE SERVICES SOCIAUX DES SOURCES,51247583,4619,545,139,4.6798038296,3755,3.1169414854,4057,341,118,4.0811710897,3200,3.3145868056,562,14,0,9.0012504943,555,1.9773648649,204,21
2021-2022,4,05,Estrie,CIUSSS DE L'ESTRIE - CENTRE HOSPITALIER UNIVERSITAIRE DE SHERBROOKE,CHUS - HÃPITAL FLEURIMONT,51216687,13295,1690,352,7.6037106682,11591,2.089102177,7026,322,154,4.7782877882,5324,3.2803499875,6269,565,21,10.770311586,6267,1.0771022818,1368,198
2021-2022,4,05,Estrie,CIUSSS DE L'ESTRIE - CENTRE HOSPITALIER UNIVERSITAIRE DE SHERBROOKE,CHUS - HÃTEL-DIEU DE SHERBROOKE,51216695,13971,2527,1638,8.8975604228,11679,2.3840725519,6734,613,350,4.4316627067,4456,3.5046154997,7237,977,204,13.05306066,7223,1.6927892381,1914,1288
2021-2022,4,05,Estrie,CIUSSS DE L'ESTRIE - CENTRE HOSPITALIER UNIVERSITAIRE DE SHERBROOKE,HÃPITAL BROME-MISSISQUOI-PERKINS,51229185,8115,1213,238,8.5915270076,6568,3.2893143524,5581,394,112,5.1343305162,4056,3.7993014464,2534,567,130,16.205818096,2512,2.4658638535,819,126
2021-2022,4,05,Estrie,CIUSSS DE L'ESTRIE - CENTRE HOSPITALIER UNIVERSITAIRE DE SHERBROOKE,HÃPITAL DE GRANBY,51228120,11429,1746,791,9.3659081187,9062,3.4740529746,7707,610,272,5.6550986117,5362,4.3843158647,3722,954,157,17.049736402,3700,2.1549098348,1136,519
2021-2022,4,06,MontrÃ©al,CENTRE HOSPITALIER DE L'UNIVERSITÃ DE MONTRÃAL,CENTRE HOSPITALIER DE L'UNIVERSITÃ DE MONTRÃAL,51236297,18209,2737,1405,12.809837016,15279,2.6895632895,10810,778,476,6.5080660911,7930,3.7961766148,7399,2644,596,22.016776291,7349,1.4954629126,1959,929
2021-2022,4,06,MontrÃ©al,CENTRE HOSPITALIER UNIVERSITAIRE SAINTE-JUSTINE,CHU SAINTE-JUSTINE,51222800,24554,1,730,5.1906394296,21781,1.9370570681,17657,1,375,4.5673057428,15101,2.21223955,6897,60,0,6.7864351248,6680,1.3149716401,0,355
2021-2022,4,06,MontrÃ©al,CENTRE UNIVERSITAIRE DE SANTÃ MCGILL,HÃPITAL DE LACHINE,51228310,4856,837,238,8.9207383763,4508,2.0586204772,3204,304,75,3.8205836454,2877,2.1306902445,1652,402,139,18.812321765,1631,1.9314931194,533,163
2021-2022,4,06,MontrÃ©al,CENTRE UNIVERSITAIRE DE SANTÃ MCGILL,HÃPITAL GÃNÃRAL DE MONTRÃAL,51248219,9206,1471,1085,12.459028955,8064,1.7893382799,3180,198,201,5.0644745807,2087,2.6134957142,6026,1226,358,16.361233221,5977,1.5015657242,1273,884
2021-2022,4,06,MontrÃ©al,CENTRE UNIVERSITAIRE DE SANTÃ MCGILL,HÃPITAL ROYAL VICTORIA,51223295,14594,2206,302,14.023171642,11606,3.737994476,9541,665,159,7.5672709301,6602,4.642227145,5053,1905,810,26.213108055,5004,2.5450000555,1541,143
2021-2022,4,06,MontrÃ©al,CENTRE UNIVERSITAIRE DE SANTÃ MCGILL,L'HÃPITAL DE MONTRÃAL POUR ENFANTS,51223279,21269,0,868,5.7312115703,19461,2.0411376171,16769,0,280,4.9893415264,14977,2.361634599,4500,116,6,8.4957490741,4484,0.9706462484,0,588
2021-2022,4,06,MontrÃ©al,CIUSSS DE L'EST-DE-L'ÃLE-DE-MONTRÃAL,HÃPITAL MAISONNEUVE-ROSEMONT,12934659,19250,3418,1652,13.071348557,14157,3.9048301979,11033,751,446,6.2606597883,6051,5.4446546025,8217,2981,875,22.216088631,8106,2.7553757847,2667,1206
2021-2022,4,06,MontrÃ©al,CIUSSS DE L'EST-DE-L'ÃLE-DE-MONTRÃAL,HÃPITAL SANTA CABRINI,51235919,9652,2262,378,12.828206014,8311,3.0619685758,5727,545,141,5.6026198999,4397,4.2429323655,3925,1372,486,23.371118542,3914,1.735270113,1717,237
2021-2022,4,06,MontrÃ©al,CIUSSS DE L'EST-DE-L'ÃLE-DE-MONTRÃAL,INSTITUT UNIVERSITAIRE EN SANTÃ MENTALE DE MONTRÃAL,51235307,1341,51,1337,13.652289958,1316,1.1129263762,625,12,622,3.2759444444,600,1.2706666667,716,280,87,22.709854128,716,0.9807417753,39,715
2021-2022,4,06,MontrÃ©al,CIUSSS DE L'OUEST-DE-L'ÃLE-DE-MONTRÃAL,CENTRE HOSPITALIER DE ST. MARY,51248243,9862,1865,768,9.3889648257,9335,2.0156870797,6507,595,252,4.9378854823,5982,2.4062855232,3355,883,82,18.021803361,3353,1.3188305663,1270,516
2021-2022,4,06,MontrÃ©al,CIUSSS DE L'OUEST-DE-L'ÃLE-DE-MONTRÃAL,HÃPITAL DE LASALLE,51224392,7737,990,244,8.9869765413,6377,3.4345549544,5747,370,103,5.9459329022,4402,4.0142353223,1990,519,97,17.769327192,1975,2.1425281294,620,141
2021-2022,4,06,MontrÃ©al,CIUSSS DE L'OUEST-DE-L'ÃLE-DE-MONTRÃAL,HÃPITAL DOUGLAS,51235190,1915,40,1832,7.097964897,1724,2.3294341325,1039,19,958,3.5801518554,849,2.1865871614,876,86,0,11.270348174,875,2.4680365079,21,874
2021-2022,4,06,MontrÃ©al,CIUSSS DE L'OUEST-DE-L'ÃLE-DE-MONTRÃAL,HÃPITAL GÃNÃRAL DU LAKESHORE,51228278,11624,2308,605,14.561946308,9770,2.9707269987,7396,700,78,7.4666028183,5552,3.8955411463,4228,1678,815,26.973762877,4218,1.7534277699,1608,527
2021-2022,4,06,MontrÃ©al,CIUSSS DU CENTRE-OUEST-DE-L'ÃLE-DE-MONTRÃAL,HÃPITAL GÃNÃRAL JUIF,51248250,25263,4261,1287,8.8806114234,23097,1.8738634046,10756,619,184,4.0499103343,8829,2.1640094197,14507,1844,362,12.462263103,14268,1.6943218313,3642,1103
2021-2022,4,06,MontrÃ©al,CIUSSS DU CENTRE-SUD-DE-L'ÃLE-DE-MONTRÃAL,HÃPITAL DE VERDUN,51218097,10992,1746,926,9.5137384007,9938,1.7647836028,7144,556,308,3.8065589228,6107,2.200185352,3848,1356,228,20.109395934,3831,1.0707093448,1190,618
2021-2022,4,06,MontrÃ©al,CIUSSS DU CENTRE-SUD-DE-L'ÃLE-DE-MONTRÃAL,HÃPITAL NOTRE-DAME,51236313,10635,1276,1502,12.744389202,9016,2.6456195159,6870,336,665,6.005168001,5267,3.4699478409,3765,1439,491,25.041454183,3749,1.4875140778,940,837
2021-2022,4,06,MontrÃ©al,CIUSSS DU NORD-DE-L'ÃLE-DE-MONTRÃAL,HÃPITAL DU SACRÃ-COEUR-DE-MONTRÃAL,12475976,17738,3218,848,10.975278749,15136,2.4785062104,11418,957,392,5.5531727681,8828,3.3943525336,6320,2152,581,20.771102496,6308,1.1967859596,2261,456
2021-2022,4,06,MontrÃ©al,CIUSSS DU NORD-DE-L'ÃLE-DE-MONTRÃAL,HÃPITAL EN SANTÃ MENTALE ALBERT-PRÃVOST,51848752,950,35,947,16.96130731,941,0.2079233085,415,11,412,3.3989738956,406,0.311690613,535,259,68,27.481622015,535,0.1291765317,24,535
2021-2022,4,06,MontrÃ©al,CIUSSS DU NORD-DE-L'ÃLE-DE-MONTRÃAL,HÃPITAL FLEURY,51228492,9154,1365,377,8.403937107,6885,3.2794450496,6937,576,195,5.3762749668,4676,3.9357879479,2217,609,41,17.877501504,2209,1.8901017303,789,182
2021-2022,4,06,MontrÃ©al,CIUSSS DU NORD-DE-L'ÃLE-DE-MONTRÃAL,HÃPITAL JEAN-TALON,51228500,11244,1461,957,7.8039087513,9174,2.8428660102,8277,473,431,5.0008577987,6215,3.6016329221,2967,637,42,15.623542299,2959,1.2491734257,988,526
2021-2022,4,06,MontrÃ©al,INSTITUT DE CARDIOLOGIE DE MONTRÃAL,INSTITUT DE CARDIOLOGIE DE MONTRÃAL,51248201,5245,1442,162,9.4661357907,5086,1.4794089986,3161,579,137,3.4830661886,3004,1.6997823273,2084,637,57,18.541223608,2082,1.1614447913,863,25
2021-2022,4,07,Outaouais,CISSS DE L'OUTAOUAIS,CENTRE MULTISERVICES DE SANTÃ ET DE SERVICES SOCIAUX DE MANSFIELD-ET-PONTEFRACT,51245058,2263,274,83,4.7841654392,2169,1.2508047743,2173,258,80,4.5730747303,2079,1.2455853509,90,4,0,9.8808333333,90,1.3713734568,16,3
2021-2022,4,07,Outaouais,CISSS DE L'OUTAOUAIS,CLSC ET CENTRE D'HÃBERGEMENT DE LA PETITE-NATION,51219491,2713,315,125,2.9570257403,2409,1.3062972188,2456,245,114,2.7607053022,2152,1.3656048637,257,1,0,4.8331463467,257,0.8096822309,70,11
2021-2022,4,07,Outaouais,CISSS DE L'OUTAOUAIS,HÃPITAL DE GATINEAU,51221703,9047,1076,1267,10.466105707,5960,2.668186428,5709,401,342,3.5841926004,2681,2.8608973642,3338,969,490,22.236280041,3279,2.5106207008,675,925
2021-2022,4,07,Outaouais,CISSS DE L'OUTAOUAIS,HÃPITAL DE HULL,51221711,9968,1670,433,10.591426231,7104,2.4957278372,6007,440,268,4.2133092873,3204,2.7715297718,3961,1018,423,20.264071643,3900,2.2691459402,1230,165
2021-2022,4,07,Outaouais,CISSS DE L'OUTAOUAIS,HÃPITAL DE MANIWAKI,51221893,3541,528,210,7.1945928645,3077,2.2495590041,2451,262,111,3.6554463031,2026,2.2794892783,1090,180,95,15.152802243,1051,2.1918627762,266,99
2021-2022,4,07,Outaouais,CISSS DE L'OUTAOUAIS,HÃPITAL ET CHSLD DE PAPINEAU,51228823,5773,707,292,7.2121024116,4179,2.8680737018,4113,268,91,3.339955696,2542,2.9439911706,1660,365,47,16.806162316,1637,2.7501859771,439,201
2021-2022,4,07,Outaouais,CISSS DE L'OUTAOUAIS,HÃPITAL ET CHSLD DU PONTIAC,51219459,2513,328,56,4.7485635805,2325,1.7429719235,2277,260,43,4.1575226907,2089,1.8106973033,236,16,0,10.451106403,236,1.1434875235,68,13
2021-2022,4,07,Outaouais,CISSS DE L'OUTAOUAIS,HÃPITAL ET CHSLD MÃMORIAL DE WAKEFIELD / WAKEFIELD MEMORIAL HOSPITAL,51228799,3647,312,105,5.2563853852,3226,2.2684701557,3254,207,84,4.0336437205,2839,2.3319583382,393,82,8,15.380561917,387,1.8027260982,105,21
2021-2022,4,08,Abitibi-TÃ©miscamingue,CISSS DE L'ABITIBI-TÃMISCAMINGUE,CENTRE MULTISERVICES DE SANTÃ ET DE SERVICES SOCIAUX DE LA SARRE,51247559,5230,586,285,4.4630457829,4777,1.7863356244,4500,386,250,3.9209804321,4054,1.8616686537,730,23,0,7.8045445205,723,1.3639288459,200,35
2021-2022,4,08,Abitibi-TÃ©miscamingue,CISSS DE L'ABITIBI-TÃMISCAMINGUE,CENTRE MULTISERVICES DE SANTÃ ET DE SERVICES SOCIAUX DE TÃMISCAMING-KIPAWA,51247476,1406,133,97,2.1891070017,1298,0.5533729242,1386,124,92,2.0489409973,1278,0.5564343158,20,0,0,11.902611111,20,0.35775,9,5
2021-2022,4,08,Abitibi-TÃ©miscamingue,CISSS DE L'ABITIBI-TÃMISCAMINGUE,CENTRE MULTISERVICES DE SANTÃ ET DE SERVICES SOCIAUX DE VILLE-MARIE,51247542,3353,448,192,4.630641134,2971,2.4262286361,3003,335,151,3.9912271062,2624,2.4869905996,350,14,0,10.116813492,347,1.9667491194,113,41
2021-2022,4,08,Abitibi-TÃ©miscamingue,CISSS DE L'ABITIBI-TÃMISCAMINGUE,HÃPITAL D'AMOS,51228906,5688,555,258,4.7252993632,5050,1.149520297,4215,233,194,2.39025201,3584,1.3165848214,1473,194,31,11.407054009,1466,0.7410896999,322,64
2021-2022,4,08,Abitibi-TÃ©miscamingue,CISSS DE L'ABITIBI-TÃMISCAMINGUE,HÃPITAL DE ROUYN-NORANDA,51228922,7584,942,477,6.082822902,5745,3.2387551494,6002,463,288,5.0038037784,4181,3.7360138457,1582,114,6,10.176547795,1564,1.9094465757,479,189
2021-2022,4,08,Abitibi-TÃ©miscamingue,CISSS DE L'ABITIBI-TÃMISCAMINGUE,HÃPITAL DE VAL-D'OR,51225589,7801,806,676,7.5791168511,6007,3.8960531232,6185,430,481,5.3771100781,4396,4.5765678395,1616,369,71,16.006970744,1611,2.0391054555,376,195
2021-2022,4,09,CÃ´te-Nord,CISSS DE LA CÃTE-NORD,CENTRE MULTISERVICES DE SANTÃ ET DE SERVICES SOCIAUX DE FERMONT,51245108,1373,5,66,5.3180927814,1170,1.3780797721,1320,4,65,5.2851439394,1117,1.4013279618,53,1,1,6.1387054507,53,0.8881132075,1,1
2021-2022,4,09,CÃ´te-Nord,CISSS DE LA CÃTE-NORD,CENTRE MULTISERVICES DE SANTÃ ET DE SERVICES SOCIAUX DE FORESTVILLE,51218741,2834,411,125,3.2060396573,2281,1.7199691899,2451,298,94,2.7376756653,1942,1.8234769424,383,9,0,6.2033246301,339,1.1270132743,113,31
2021-2022,4,09,CÃ´te-Nord,CISSS DE LA CÃTE-NORD,CENTRE MULTISERVICES DE SANTÃ ET DE SERVICES SOCIAUX DE LA BASSE-CÃTE-NORD,51245140,998,135,56,3.3355096304,974,1.2002572439,827,94,52,3.1788277576,805,1.2344851622,171,0,0,4.0932634828,169,1.0372189349,41,4
2021-2022,4,09,CÃ´te-Nord,CISSS DE LA CÃTE-NORD,CENTRE MULTISERVICES DE SANTÃ ET DE SERVICES SOCIAUX DE LA MINGANIE,51245116,3820,260,124,2.2423791449,1900,1.7679138889,2863,168,56,1.4925006792,983,1.8772004634,957,8,0,4.4857459654,917,1.6507615413,92,68
2021-2022,4,09,CÃ´te-Nord,CISSS DE LA CÃTE-NORD,CENTRE MULTISERVICES DE SANTÃ ET DE SERVICES SOCIAUX DE PORT-CARTIER,51245132,3638,291,169,4.0929825606,3232,1.8761898377,3257,201,130,2.9008567871,2856,1.9968684835,381,61,18,14.283937008,376,0.959545656,90,39
2021-2022,4,09,CÃ´te-Nord,CISSS DE LA CÃTE-NORD,CENTRE MULTISERVICES DE SANTÃ ET DE SERVICES SOCIAUX DES ESCOUMINS,51218733,2556,402,70,2.9824446835,2286,1.0628421794,2215,273,56,2.4784127163,1946,1.1062101747,341,4,0,6.256435321,340,0.814624183,129,14
2021-2022,4,09,CÃ´te-Nord,CISSS DE LA CÃTE-NORD,CLSC ET HÃPITAL LE ROYER,51228765,6029,913,481,9.1647587586,5364,3.3445990244,4351,370,287,5.2706622999,3691,3.8634726361,1678,456,162,19.26202556,1673,2.1998515641,543,194
2021-2022,4,09,CÃ´te-Nord,CISSS DE LA CÃTE-NORD,HÃPITAL ET CLSC DE SEPT-ÃLES,51232023,5811,714,436,10.01846063,4498,2.8766806235,3617,270,141,3.8094195619,2358,3.0444954528,2194,550,245,20.254605363,2140,2.6917706386,444,295
2021-2022,4,11,GaspÃ©sie-Ãles-de-la-Madeleine,CISSS DE LA GASPÃSIE,CENTRE MULTISERVICES DE SANTÃ ET DE SERVICES SOCIAUX DE GRANDE-VALLÃE,51247732,1630,249,20,1.4490010225,1126,0.7402425005,1494,207,16,1.1806751078,1018,0.768676599,136,1,0,4.3966401144,108,0.4722247942,42,4
2021-2022,4,11,GaspÃ©sie-Ãles-de-la-Madeleine,CISSS DE LA GASPÃSIE,CLSC ET CENTRE DE SERVICES AMBULATOIRES DE MURDOCHVILLE,51221307,465,76,36,3.1857108722,449,1.5111463747,461,74,36,3.1188280309,445,1.5230980025,4,0,0,10.893958333,4,0.1815277778,2,0
2021-2022,4,11,GaspÃ©sie-Ãles-de-la-Madeleine,CISSS DE LA GASPÃSIE,CLSC ET CENTRE DE SERVICES AMBULATOIRES DE PASPÃBIAC,51220978,3432,628,137,3.4957307854,3181,1.5967212442,2552,396,107,2.7305600183,2341,1.6633398595,880,18,1,5.7147260101,840,1.4110615079,232,30
2021-2022,4,11,GaspÃ©sie-Ãles-de-la-Madeleine,CISSS DE LA GASPÃSIE,HÃPITAL DE CHANDLER,51227775,4261,696,163,4.7754050301,3759,1.694038382,3571,438,138,3.3917624226,3072,1.8395524993,690,55,1,11.936256844,687,1.0433551674,258,25
2021-2022,4,11,GaspÃ©sie-Ãles-de-la-Madeleine,CISSS DE LA GASPÃSIE,HÃPITAL DE GASPÃ,51220903,3919,651,178,4.4733200788,3491,1.3407663357,3146,390,150,3.2065384615,2719,1.4980723101,773,32,0,9.6289409947,772,0.7867314335,261,28
2021-2022,4,11,GaspÃ©sie-Ãles-de-la-Madeleine,CISSS DE LA GASPÃSIE,HÃPITAL ET CLSC DE SAINTE-ANNE-DES-MONTS,51247799,3894,594,173,3.8355417879,3538,1.3245406224,3149,342,127,2.198548481,2796,1.3622589811,745,73,17,10.754859806,742,1.1824105271,252,46
2021-2022,4,11,GaspÃ©sie-Ãles-de-la-Madeleine,CISSS DE LA GASPÃSIE,HÃPITAL ET GROUPE DE MÃDECINE DE FAMILLE UNIVERSITAIRE DE MARIA,51227908,4556,834,211,8.103179263,4149,2.170828312,3236,366,90,4.1615836595,2830,2.4459275618,1320,362,88,17.766060606,1319,1.5805850392,468,121
2021-2022,4,11,GaspÃ©sie-Ãles-de-la-Madeleine,CISSS DES ÃLES,HÃPITAL DE L'ARCHIPEL,51227783,3901,473,114,3.3972896551,3392,0.7994792486,3114,283,53,2.033254924,2609,0.8554908224,787,38,1,8.7944995059,783,0.6128455371,190,61
2021-2022,4,12,ChaudiÃ¨re-Appalaches,CISSS DE CHAUDIÃRE-APPALACHES,HÃPITAL DE MONTMAGNY,51245223,8774,1383,319,4.2476274599,8042,1.1313935519,6539,648,139,2.1333423391,5808,1.3085570191,2235,131,1,10.43344867,2234,0.6708002586,735,180
2021-2022,4,12,ChaudiÃ¨re-Appalaches,CISSS DE CHAUDIÃRE-APPALACHES,HÃPITAL DE SAINT-GEORGES,51228971,11316,1900,660,6.2382945976,9419,1.8865695521,7615,663,288,3.3001590428,5728,2.3092508535,3701,349,11,12.283661323,3691,1.2306176435,1237,372
2021-2022,4,12,ChaudiÃ¨re-Appalaches,CISSS DE CHAUDIÃRE-APPALACHES,HÃPITAL DE THETFORD,51245231,10090,1659,348,5.2784207962,8858,1.1124012192,7616,832,177,3.3085177769,6384,1.2371206227,2474,186,1,11.342600826,2474,0.7905707132,827,171
2021-2022,4,12,ChaudiÃ¨re-Appalaches,CISSS DE CHAUDIÃRE-APPALACHES,HÃTEL-DIEU DE LÃVIS,51227569,24050,4116,1469,6.744409575,20587,1.1089178986,16739,1521,687,2.77669355,13278,1.3975414219,7311,1678,165,15.828748043,7309,0.5845858227,2595,782
2021-2022,4,13,Laval,CISSS DE LAVAL,HÃPITAL DE LA CITÃ-DE-LA-SANTÃ,51228757,26760,4467,1670,8.3012162224,20848,2.8899156594,17738,1413,523,5.0047934128,11851,3.7026548861,9022,1440,74,14.782256767,8997,1.8193618552,3054,1147
2021-2022,4,14,LanaudiÃ¨re,CISSS DE LANAUDIÃRE,HÃPITAL DE LANAUDIÃRE ET CENTRE D'HÃBERGEMENT PARPHILIA-FERLAND,51244945,19436,3182,1408,9.3568571208,16864,2.3079734444,12202,878,954,5.3636118624,9677,2.9398557576,7234,1747,243,16.092491437,7187,1.4571698901,2304,454
2021-2022,4,14,LanaudiÃ¨re,CISSS DE LANAUDIÃRE,HÃPITAL PIERRE-LE GARDEUR,51228062,22403,3524,1260,10.620412494,15153,4.4813843243,15143,1253,454,6.5088655558,7932,5.9490011627,7260,2427,237,19.196329201,7221,2.8692617982,2271,806
2021-2022,4,15,Laurentides,CISSS DES LAURENTIDES,CENTRE MULTISERVICES DE SANTÃ ET DE SERVICES SOCIAUX D'ARGENTEUIL,51245306,5854,695,203,8.3126460065,4883,3.1468867044,4768,372,133,5.189405178,3799,3.502332412,1086,351,105,22.024996163,1084,1.9011872181,323,70
2021-2022,4,15,Laurentides,CISSS DES LAURENTIDES,CENTRE MULTISERVICES DE SANTÃ ET DE SERVICES SOCIAUX DE RIVIÃRE-ROUGE,51217628,4087,481,253,6.0860052198,3637,2.1680577704,3094,245,120,3.1614298283,2660,2.2861705305,993,192,55,15.198428444,977,1.8464815763,236,133
2021-2022,4,15,Laurentides,CISSS DES LAURENTIDES,CENTRE MULTISERVICES DE SANTÃ ET DE SERVICES SOCIAUX DE SAINTE-AGATHE,51246874,9035,1409,616,11.789081289,7158,4.3602714135,5938,565,161,7.3875085139,4084,5.5497049461,3097,985,177,20.228390019,3074,2.7800350611,844,455
2021-2022,4,15,Laurentides,CISSS DES LAURENTIDES,HÃPITAL DE MONT-LAURIER,51217610,4881,690,263,8.4769610053,3971,3.3018634405,3680,350,145,6.0546293025,2796,3.6011428032,1201,249,46,15.899259645,1175,2.5897059102,340,118
2021-2022,4,15,Laurentides,CISSS DES LAURENTIDES,HÃPITAL DE SAINT-EUSTACHE,51228864,14790,2662,793,11.604682499,10660,3.3015905774,8884,713,259,6.0207360924,4776,5.0074644054,5906,1883,530,20.004238863,5884,1.9169451998,1949,534
2021-2022,4,15,Laurentides,CISSS DES LAURENTIDES,HÃPITAL DE SAINT-JÃRÃME,51228880,16238,2620,1469,15.473839519,11594,4.4994302609,9977,876,472,7.4209600971,5369,6.1800922994,6261,2659,1241,28.306226996,6225,3.0498761267,1744,997
2021-2022,4,16,MontÃ©rÃ©gie,CISSS DE LA MONTÃRÃGIE-CENTRE,HÃPITAL CHARLES-LE MOYNE,51233799,22207,3698,1892,9.3686166149,13203,4.077101227,15260,1317,858,5.0078247961,6262,5.0494750523,6947,2072,247,18.947669897,6941,3.1998494053,2381,1034
2021-2022,4,16,MontÃ©rÃ©gie,CISSS DE LA MONTÃRÃGIE-CENTRE,HÃPITAL DU HAUT-RICHELIEU,51229045,18340,2686,1146,9.1378268508,14391,2.6079400513,13191,1054,479,4.8401283704,9250,3.2359972973,5149,1575,524,20.147914374,5141,1.4779012406,1632,667
2021-2022,4,16,MontÃ©rÃ©gie,CISSS DE LA MONTÃRÃGIE-EST,HÃPITAL HONORÃ-MERCIER,51229193,14477,2365,848,7.4488079751,11216,2.7613092408,10766,973,402,4.2747992652,7512,3.2614261626,3711,908,81,16.656939953,3704,1.7470332373,1392,446
2021-2022,4,16,MontÃ©rÃ©gie,CISSS DE LA MONTÃRÃGIE-EST,HÃPITAL PIERRE-BOUCHER,51229011,16934,3064,1031,11.263928668,12640,3.3566657876,7897,761,287,4.5662902931,3697,4.4844337,9037,2229,765,17.116672968,8943,2.8904510977,2303,744
2021-2022,4,16,MontÃ©rÃ©gie,CISSS DE LA MONTÃRÃGIE-EST,HÃTEL-DIEU DE SOREL,51229102,9804,1627,495,8.5544335645,8350,2.446662342,6468,672,167,4.9595476448,5042,3.0709082595,3336,757,122,15.524374251,3308,1.4951968292,955,328
2021-2022,4,16,MontÃ©rÃ©gie,CISSS DE LA MONTÃRÃGIE-OUEST,HÃPITAL ANNA-LABERGE,51229151,11925,2102,686,13.183691125,9408,2.3768335459,7475,570,177,7.0036209588,4958,3.3402665725,4450,1707,489,23.564820225,4450,1.303417603,1532,509
2021-2022,4,16,MontÃ©rÃ©gie,CISSS DE LA MONTÃRÃGIE-OUEST,HÃPITAL BARRIE MEMORIAL / BARRIE MEMORIAL HOSPITAL,51228005,5550,627,95,6.1293228228,4607,3.450108229,4649,352,74,4.3169223967,3714,3.0736694489,901,209,19,15.480987175,893,5.0157225955,275,21
2021-2022,4,16,MontÃ©rÃ©gie,CISSS DE LA MONTÃRÃGIE-OUEST,HÃPITAL DU SUROÃT,51229136,10950,2114,905,14.814308777,9064,2.3641797526,6736,574,555,4.9251785184,4898,3.2354103716,4214,1424,879,30.621898104,4166,1.3398668454,1540,350
2022-2023,4,01,Bas-Saint-Laurent,CISSS DU BAS-SAINT-LAURENT,CENTRE HOSPITALIER RÃGIONAL DU GRAND-PORTAGE,51218352,6429,1040,266,4.83328088,5346,2.1592763021,4812,432,167,3.1671844117,3744,2.4090461776,1617,34,2,9.7913861403,1602,1.5755444583,608,99
2022-2023,4,01,Bas-Saint-Laurent,CISSS DU BAS-SAINT-LAURENT,CENTRE MULTISERVICES DE SANTÃ ET DE SERVICES SOCIAUX DE TROIS-PISTOLES,51236156,3181,461,87,2.9614566523,2891,1.2586120719,2780,308,68,2.2796684652,2493,1.3347882961,401,17,1,7.6880680244,398,0.7814579844,153,19
2022-2023,4,01,Bas-Saint-Laurent,CISSS DU BAS-SAINT-LAURENT,CLSC DE POHÃNÃGAMOOK,51219418,2903,344,58,1.5592077162,2648,0.6752706445,2717,289,49,1.2419637672,2465,0.6823408835,186,3,0,6.1933572282,183,0.580034912,55,9
2022-2023,4,01,Bas-Saint-Laurent,CISSS DU BAS-SAINT-LAURENT,HÃPITAL D'AMQUI,51226892,4765,704,117,3.9735579457,4185,1.641559538,2659,248,72,3.1063979775,2146,1.8558627162,2106,11,1,5.0684194629,2039,1.4160104354,456,45
2022-2023,4,01,Bas-Saint-Laurent,CISSS DU BAS-SAINT-LAURENT,HÃPITAL DE MATANE,51218980,5840,882,224,4.4969877283,5185,2.5163576556,4451,435,130,3.9946040216,3830,2.8316765303,1389,13,0,6.1068580514,1355,1.6250873309,447,94
2022-2023,4,01,Bas-Saint-Laurent,CISSS DU BAS-SAINT-LAURENT,HÃPITAL DE NOTRE-DAME-DU-LAC,51221877,4011,652,108,4.0400120502,3579,1.3832148955,3181,331,52,2.3290316637,2752,1.5341736313,830,54,7,10.597395917,827,0.8808709526,321,56
2022-2023,4,01,Bas-Saint-Laurent,CISSS DU BAS-SAINT-LAURENT,HÃPITAL NOTRE-DAME-DE-FATIMA,51221141,4959,750,133,3.3045889628,4590,1.3611279956,4032,398,70,2.4915139991,3669,1.4792999152,927,1,0,6.8410703584,921,0.8903649415,352,63
2022-2023,4,01,Bas-Saint-Laurent,CISSS DU BAS-SAINT-LAURENT,HÃPITAL RÃGIONAL DE RIMOUSKI,51227882,9917,1642,435,5.4447910714,7660,2.3873417464,7186,664,283,3.9430897656,4944,2.8087407295,2731,123,4,9.3961735628,2716,1.6202590615,978,152
2022-2023,4,02,Saguenay-Lac-Saint-Jean,CIUSSS DU SAGUENAY - LAC-SAINT-JEAN,HÃPITAL D'ALMA,51219400,10594,1538,353,4.9174166719,8272,2.6741935982,8239,795,152,3.5830656701,5964,2.826742166,2355,107,4,9.5856620665,2308,2.2799996389,743,201
2022-2023,4,02,Saguenay-Lac-Saint-Jean,CIUSSS DU SAGUENAY - LAC-SAINT-JEAN,HÃPITAL DE CHICOUTIMI,51218394,16713,2531,1041,7.4689929496,14219,2.4653291566,9960,740,325,3.8783655455,7531,3.2843349341,6753,967,174,12.764809467,6688,1.5430904439,1791,716
2022-2023,4,02,Saguenay-Lac-Saint-Jean,CIUSSS DU SAGUENAY - LAC-SAINT-JEAN,HÃPITAL DE DOLBEAU-MISTASSINI,51219384,6334,1000,257,4.3427153721,5720,1.8255529332,5281,622,142,2.9665093417,4677,1.9530243152,1053,120,21,11.244656537,1043,1.2539482795,378,115
2022-2023,4,02,Saguenay-Lac-Saint-Jean,CIUSSS DU SAGUENAY - LAC-SAINT-JEAN,HÃPITAL DE LA BAIE,51221364,5901,697,189,5.2053238622,5379,2.445626149,4774,332,117,3.8533859912,4259,2.6963234066,1127,89,15,10.932166272,1120,1.4923050595,365,72
2022-2023,4,02,Saguenay-Lac-Saint-Jean,CIUSSS DU SAGUENAY - LAC-SAINT-JEAN,HÃPITAL ET CENTRE D'HÃBERGEMENT DE ROBERVAL,51228203,7426,1046,459,5.6442472768,6544,2.3609543517,5182,427,141,3.3955918457,4343,2.5585871262,2244,214,47,10.83699792,2201,1.9709865465,619,318
2022-2023,4,02,Saguenay-Lac-Saint-Jean,CIUSSS DU SAGUENAY - LAC-SAINT-JEAN,HÃPITAL ET CENTRE DE RÃADAPTATION DE JONQUIÃRE,51224541,8082,1400,371,8.1898831079,6245,4.1736044391,5218,460,143,5.1320354755,3475,4.5672045564,2864,418,48,13.761059416,2770,3.6798281187,940,228
2022-2023,4,03,Capitale-Nationale,CHU DE QUÃBEC - UNIVERSITÃ LAVAL,CENTRE HOSPITALIER DE L'UNIVERSITÃ LAVAL,51217594,23369,1692,2148,7.8983989354,18331,2.1191484219,13564,350,726,4.7242214891,8556,3.2336060464,9805,1066,329,12.289479291,9775,1.1436702188,1342,1422
2022-2023,4,03,Capitale-Nationale,CHU DE QUÃBEC - UNIVERSITÃ LAVAL,HÃPITAL DE L'ENFANT-JÃSUS,51233914,17968,2920,2202,10.656756147,15915,1.7331220547,10270,943,566,4.1324637564,8219,2.1677676049,7698,2071,574,19.360897852,7696,1.2689391314,1977,1636
2022-2023,4,03,Capitale-Nationale,CHU DE QUÃBEC - UNIVERSITÃ LAVAL,HÃPITAL DU SAINT-SACREMENT,51217529,10572,2348,276,7.8603819839,8373,2.122333194,7575,970,107,3.7406622662,5384,2.5545185323,2997,789,214,18.273086976,2989,1.3438501357,1378,169
2022-2023,4,03,Capitale-Nationale,CHU DE QUÃBEC - UNIVERSITÃ LAVAL,HÃPITAL SAINT-FRANÃOIS D'ASSISE,51217602,12612,2940,394,10.206007176,10153,2.1023409884,7704,894,187,4.1921442324,5261,2.8160217217,4908,1470,372,19.6458605,4892,1.3348278368,2046,207
2022-2023,4,03,Capitale-Nationale,CHU DE QUÃBEC - UNIVERSITÃ LAVAL,L'HÃTEL-DIEU DE QUÃBEC,51217586,5993,1552,322,8.164182055,5336,1.5895104531,3061,423,108,3.3854740644,2431,1.8635580922,2932,417,17,13.153140158,2905,1.3601783324,1129,214
2022-2023,4,03,Capitale-Nationale,CIUSSS DE LA CAPITALE-NATIONALE,CENTRE MULTISERVICES DE SANTÃ ET DE SERVICES SOCIAUX CHAUVEAU,51225001,13156,885,163,3.0677302076,8670,1.8602222222,12010,747,133,2.9012959571,7556,1.9491049791,1146,0,0,4.8119495346,1114,1.2573513864,138,30
2022-2023,4,03,Capitale-Nationale,CIUSSS DE LA CAPITALE-NATIONALE,CENTRE MULTISERVICES DE SANTÃ ET DE SERVICES SOCIAUX DE BAIE-SAINT-PAUL,51244804,3845,673,87,4.2988078312,2987,1.7719654614,3063,415,40,2.6084358109,2208,1.9964870169,782,77,8,10.919791844,779,1.1355808729,258,47
2022-2023,4,03,Capitale-Nationale,CIUSSS DE LA CAPITALE-NATIONALE,CENTRE MULTISERVICES DE SANTÃ ET DE SERVICES SOCIAUX DE SAINT-MARC-DES-CARRIÃRES,51247344,5061,673,127,3.1632669762,4046,1.6384550585,4065,357,74,2.4164106874,3071,1.8967232896,996,19,1,6.211430444,975,0.8249763533,316,53
2022-2023,4,03,Capitale-Nationale,CIUSSS DE LA CAPITALE-NATIONALE,CENTRE MULTISERVICES DE SANTÃ ET DE SERVICES SOCIAUX DE SAINT-RAYMOND,51247302,6196,767,87,4.0874002493,4808,2.2458871788,5005,397,48,3.1321281496,3636,2.600540429,1191,38,2,8.1017888796,1172,1.1456148085,370,39
2022-2023,4,03,Capitale-Nationale,CIUSSS DE LA CAPITALE-NATIONALE,CENTRE MULTISERVICES DE SANTÃ ET DE SERVICES SOCIAUX DE SAINTE-ANNE-DE-BEAUPRÃ,51225357,5457,607,87,3.6821390976,3967,2.0508447469,4686,371,65,3.0480915374,3235,2.2416430534,771,21,3,7.5357666811,732,1.2076309199,236,22
2022-2023,4,03,Capitale-Nationale,CIUSSS DE LA CAPITALE-NATIONALE,HÃPITAL ET CLSC DE LA MALBAIE,51228690,4209,695,129,5.6303532114,3492,1.8181382048,3361,423,78,3.2232588681,2648,2.1030238755,848,160,36,15.17073539,844,0.9243262902,272,51
2022-2023,4,03,Capitale-Nationale,INSTITUT UNIVERSITAIRE DE CARDIOLOGIE ET DE PNEUMOLOGIE DE QUÃBEC - UNIVERSITÃ LAVAL,INSTITUT UNIVERSITAIRE DE CARDIOLOGIE ET DE PNEUMOLOGIE DE QUÃBEC,51232130,8259,2603,180,8.2668684667,7751,2.0260652747,4220,855,82,4.0244720906,3724,2.5218149541,4039,431,0,12.699379659,4027,1.5676168502,1748,98
2022-2023,4,04,Mauricie et Centre-du-QuÃ©bec,CIUSSS DE LA MAURICIE-ET-DU-CENTRE-DU-QUÃBEC,CENTRE MULTISERVICES DE SANTÃ ET DE SERVICES SOCIAUX AVELLIN-DALCOURT,51233583,6614,858,162,5.9396226019,5296,3.9225841306,5567,467,107,5.2109157635,4256,4.4500848475,1047,44,5,9.814227157,1040,1.7638888889,391,55
2022-2023,4,04,Mauricie et Centre-du-QuÃ©bec,CIUSSS DE LA MAURICIE-ET-DU-CENTRE-DU-QUÃBEC,CENTRE MULTISERVICES DE SANTÃ ET DE SERVICES SOCIAUX CHRIST-ROI,51246338,7000,724,177,5.7587771825,5046,4.2307652926,5960,362,110,4.8620695843,4026,4.5333892201,1040,88,10,10.897601496,1020,3.0362908497,362,67
2022-2023,4,04,Mauricie et Centre-du-QuÃ©bec,CIUSSS DE LA MAURICIE-ET-DU-CENTRE-DU-QUÃBEC,CENTRE MULTISERVICES DE SANTÃ ET DE SERVICES SOCIAUX DE FORTIERVILLE,51219160,4818,377,86,2.254303307,3690,1.802563234,4465,319,73,2.1360476546,3340,1.8753858949,353,0,0,3.7500865596,350,1.1076269841,58,13
2022-2023,4,04,Mauricie et Centre-du-QuÃ©bec,CIUSSS DE LA MAURICIE-ET-DU-CENTRE-DU-QUÃBEC,CENTRE MULTISERVICES DE SANTÃ ET DE SERVICES SOCIAUX DU HAUT-SAINT-MAURICE,51219731,3718,584,206,5.3501105732,3125,2.8283808889,2794,310,105,3.9001337191,2228,3.0722970277,924,40,1,9.7345643939,897,2.2225334448,274,101
2022-2023,4,04,Mauricie et Centre-du-QuÃ©bec,CIUSSS DE LA MAURICIE-ET-DU-CENTRE-DU-QUÃBEC,HÃPITAL DU CENTRE-DE-LA-MAURICIE,51220051,10195,1918,741,7.5928002561,7926,2.8096416155,6184,512,143,4.5654489184,3949,3.9290245772,4011,445,40,12.260249938,3977,1.6981396502,1406,598
2022-2023,4,04,Mauricie et Centre-du-QuÃ©bec,CIUSSS DE LA MAURICIE-ET-DU-CENTRE-DU-QUÃBEC,HÃPITAL SAINTE-CROIX,51228781,12880,1647,735,8.5433076691,9517,3.6934014279,8279,546,188,6.306652038,5023,4.7829371004,4601,582,17,12.567926658,4494,2.4756137813,1101,547
2022-2023,4,04,Mauricie et Centre-du-QuÃ©bec,CIUSSS DE LA MAURICIE-ET-DU-CENTRE-DU-QUÃBEC,HÃTEL-DIEU D'ARTHABASKA,51228039,10975,1811,674,6.4472914452,8833,2.2000661975,6678,584,160,3.659848258,4596,2.7636060342,4297,426,37,10.779277855,4237,1.5887777647,1227,514
2022-2023,4,04,Mauricie et Centre-du-QuÃ©bec,CIUSSS DE LA MAURICIE-ET-DU-CENTRE-DU-QUÃBEC,PAVILLON SAINTE-MARIE,51220168,18173,3917,1082,10.741270551,13171,3.800325104,10129,878,302,5.8064063854,5238,5.7892404862,8044,1971,253,16.955248563,7933,2.4870843663,3039,780
2022-2023,4,05,Estrie,CIUSSS DE L'ESTRIE - CENTRE HOSPITALIER UNIVERSITAIRE DE SHERBROOKE,CENTRE DE SANTÃ ET DE SERVICES SOCIAUX DU GRANIT,51223832,4629,730,146,6.2269613667,3798,3.4448635247,3763,441,81,4.8126612927,2942,3.8012699222,866,105,14,12.372470811,856,2.2199247144,289,65
2022-2023,4,05,Estrie,CIUSSS DE L'ESTRIE - CENTRE HOSPITALIER UNIVERSITAIRE DE SHERBROOKE,CENTRE MULTISERVICES DE SANTÃ ET DE SERVICES SOCIAUX DE LA MRC DE COATICOOK,51247617,4977,317,129,2.4197441565,4386,1.5332592339,3886,166,86,2.202511866,3309,1.6041238541,1091,0,0,3.1934973012,1077,1.3155331167,151,43
2022-2023,4,05,Estrie,CIUSSS DE L'ESTRIE - CENTRE HOSPITALIER UNIVERSITAIRE DE SHERBROOKE,CENTRE MULTISERVICES DE SANTÃ ET DE SERVICES SOCIAUX DE MEMPHRÃMAGOG,51219046,7028,1353,246,6.7559247138,5880,2.6587613379,5179,611,138,3.8565534423,4055,2.9558319633,1849,333,128,14.87698681,1825,1.998694825,742,108
2022-2023,4,05,Estrie,CIUSSS DE L'ESTRIE - CENTRE HOSPITALIER UNIVERSITAIRE DE SHERBROOKE,CENTRE MULTISERVICES DE SANTÃ ET DE SERVICES SOCIAUX DES SOURCES,51247583,5386,577,166,5.9654410096,4101,4.0109759815,4742,371,127,5.237752472,3467,4.3076911675,644,54,7,11.323669341,634,2.3884025587,206,39
2022-2023,4,05,Estrie,CIUSSS DE L'ESTRIE - CENTRE HOSPITALIER UNIVERSITAIRE DE SHERBROOKE,CHUS - HÃPITAL FLEURIMONT,51216687,14594,1874,321,8.1679091864,12193,2.7982612975,8029,353,137,5.5836156433,5629,4.5030171138,6565,736,47,11.328502158,6564,1.3363370912,1521,184
2022-2023,4,05,Estrie,CIUSSS DE L'ESTRIE - CENTRE HOSPITALIER UNIVERSITAIRE DE SHERBROOKE,CHUS - HÃTEL-DIEU DE SHERBROOKE,51216695,14744,2708,1806,10.397131036,12220,2.8101813966,7163,562,299,5.3531108939,4651,4.4168386727,7581,1528,365,15.16303478,7569,1.8229224468,2146,1507
2022-2023,4,05,Estrie,CIUSSS DE L'ESTRIE - CENTRE HOSPITALIER UNIVERSITAIRE DE SHERBROOKE,HÃPITAL BROME-MISSISQUOI-PERKINS,51229185,8517,1369,267,9.5957609291,6625,3.5516027254,6099,491,122,5.1082322239,4238,4.0748826753,2418,711,282,20.914800455,2387,2.622545152,878,145
2022-2023,4,05,Estrie,CIUSSS DE L'ESTRIE - CENTRE HOSPITALIER UNIVERSITAIRE DE SHERBROOKE,HÃPITAL DE GRANBY,51228120,11706,1901,678,10.462287716,8771,4.1658871407,8017,694,260,6.2384984339,5106,5.300337457,3689,1199,245,19.641501235,3665,2.5853951038,1207,418
2022-2023,4,06,MontrÃ©al,CENTRE HOSPITALIER DE L'UNIVERSITÃ DE MONTRÃAL,CENTRE HOSPITALIER DE L'UNIVERSITÃ DE MONTRÃAL,51236297,19938,2764,1631,14.295835632,15362,3.2727710151,12243,785,644,7.6950053092,7738,5.0526366991,7695,3124,1016,24.797975417,7624,1.4662913898,1979,987
2022-2023,4,06,MontrÃ©al,CENTRE HOSPITALIER UNIVERSITAIRE SAINTE-JUSTINE,CHU SAINTE-JUSTINE,51222800,28741,0,619,5.8812887803,22458,2.9420741557,19674,0,298,5.2603055076,14001,3.4887690959,9067,114,2,7.2287272833,8457,2.0369924652,0,321
2022-2023,4,06,MontrÃ©al,CENTRE UNIVERSITAIRE DE SANTÃ MCGILL,HÃPITAL DE LACHINE,51228310,5877,543,123,6.3160803414,5267,2.843955815,4933,267,70,4.1018250107,4329,2.9200421575,944,229,61,17.88697181,938,2.4928067993,276,53
2022-2023,4,06,MontrÃ©al,CENTRE UNIVERSITAIRE DE SANTÃ MCGILL,HÃPITAL GÃNÃRAL DE MONTRÃAL,51248219,9577,1587,1115,15.743286056,8080,1.9757509282,4046,325,224,5.9747660927,2604,3.038776775,5531,1607,774,22.88908822,5476,1.4702506899,1262,891
2022-2023,4,06,MontrÃ©al,CENTRE UNIVERSITAIRE DE SANTÃ MCGILL,HÃPITAL ROYAL VICTORIA,51223295,14534,2179,363,15.826794738,10894,4.4159222202,9457,667,185,8.5543336506,5903,5.7372135167,5077,2154,1018,29.373311284,4991,2.8531928026,1512,178
2022-2023,4,06,MontrÃ©al,CENTRE UNIVERSITAIRE DE SANTÃ MCGILL,L'HÃPITAL DE MONTRÃAL POUR ENFANTS,51223279,25187,2,831,7.4796322397,20402,2.9511813929,19834,0,234,6.9481247829,15104,3.5421319592,5353,250,23,9.4489800631,5298,1.2664480307,2,597
2022-2023,4,06,MontrÃ©al,CIUSSS DE L'EST-DE-L'ÃLE-DE-MONTRÃAL,HÃPITAL MAISONNEUVE-ROSEMONT,12934659,20407,3751,1592,13.38943071,14517,3.6635726887,11913,908,373,5.9025806542,6204,5.0815027043,8494,3001,1234,23.889883349,8313,2.6053701365,2843,1219
2022-2023,4,06,MontrÃ©al,CIUSSS DE L'EST-DE-L'ÃLE-DE-MONTRÃAL,HÃPITAL SANTA CABRINI,51235919,10780,2730,321,13.026145125,8393,3.0879841998,6636,739,133,5.2361582027,4266,4.2970483669,4144,1545,693,25.500651209,4127,1.8381979781,1991,188
2022-2023,4,06,MontrÃ©al,CIUSSS DE L'EST-DE-L'ÃLE-DE-MONTRÃAL,INSTITUT UNIVERSITAIRE EN SANTÃ MENTALE DE MONTRÃAL,51235307,1356,59,1352,18.149683505,1303,1.4103809585,558,18,554,3.4588635006,505,1.6430060506,798,407,142,28.422211779,798,1.2631683375,41,798
2022-2023,4,06,MontrÃ©al,CIUSSS DE L'OUEST-DE-L'ÃLE-DE-MONTRÃAL,CENTRE HOSPITALIER DE ST. MARY,51248243,10469,1960,733,9.7464027393,9675,2.3181520815,7132,620,281,5.4890799682,6346,2.7597353101,3337,917,145,18.845361685,3329,1.4763716164,1340,452
2022-2023,4,06,MontrÃ©al,CIUSSS DE L'OUEST-DE-L'ÃLE-DE-MONTRÃAL,HÃPITAL DE LASALLE,51224392,7854,1252,242,10.474656226,6018,3.3609324803,5930,503,82,5.7705778059,4123,3.9848556202,1924,660,295,24.973193145,1895,2.0034469364,749,160
2022-2023,4,06,MontrÃ©al,CIUSSS DE L'OUEST-DE-L'ÃLE-DE-MONTRÃAL,HÃPITAL DOUGLAS,51235190,1572,36,1497,7.4658237913,1406,1.8305377746,892,15,818,3.2886428749,726,1.8299012856,680,83,9,12.945302288,680,1.8312173203,21,679
2022-2023,4,06,MontrÃ©al,CIUSSS DE L'OUEST-DE-L'ÃLE-DE-MONTRÃAL,HÃPITAL GÃNÃRAL DU LAKESHORE,51228278,11710,2475,921,14.627512691,9472,2.708983202,7631,742,164,6.9081888205,5407,3.4959175863,4079,1590,802,29.068836657,4065,1.6622539975,1733,757
2022-2023,4,06,MontrÃ©al,CIUSSS DU CENTRE-OUEST-DE-L'ÃLE-DE-MONTRÃAL,HÃPITAL GÃNÃRAL JUIF,51248250,26678,4958,1488,10.129324298,23326,2.4346662523,10454,703,174,4.2940555184,7592,2.9488776563,16224,2396,642,13.88930333,15734,2.1865479747,4255,1314
2022-2023,4,06,MontrÃ©al,CIUSSS DU CENTRE-SUD-DE-L'ÃLE-DE-MONTRÃAL,HÃPITAL DE VERDUN,51218097,12427,1967,807,8.4579717774,11020,2.0454663239,8349,566,296,4.1376442288,6955,2.5665865884,4078,1080,99,17.30309554,4065,1.1538571136,1401,511
2022-2023,4,06,MontrÃ©al,CIUSSS DU CENTRE-SUD-DE-L'ÃLE-DE-MONTRÃAL,HÃPITAL NOTRE-DAME,51236313,11030,1402,1486,13.077753979,9416,2.332644199,6874,297,564,5.6068686758,5274,3.1935422197,4156,1576,553,25.434555128,4142,1.2364645367,1105,922
2022-2023,4,06,MontrÃ©al,CIUSSS DU NORD-DE-L'ÃLE-DE-MONTRÃAL,HÃPITAL DU SACRÃ-COEUR-DE-MONTRÃAL,12475976,19221,3495,972,12.263751886,15431,3.0441227975,12973,1114,480,6.6387330738,9204,4.1793223055,6248,2442,894,23.943228366,6227,1.3662078672,2381,492
2022-2023,4,06,MontrÃ©al,CIUSSS DU NORD-DE-L'ÃLE-DE-MONTRÃAL,HÃPITAL EN SANTÃ MENTALE ALBERT-PRÃVOST,51848752,1043,46,1039,20.199106477,1034,0.3283150655,487,13,483,3.972569587,478,0.4498152022,556,336,137,34.411918465,556,0.2238599121,33,556
2022-2023,4,06,MontrÃ©al,CIUSSS DU NORD-DE-L'ÃLE-DE-MONTRÃAL,HÃPITAL FLEURY,51228492,9403,1530,314,10.068546681,6844,3.5695110072,7031,616,167,5.7725609997,4486,4.4164505622,2372,989,150,22.802558202,2358,1.9582426256,914,147
2022-2023,4,06,MontrÃ©al,CIUSSS DU NORD-DE-L'ÃLE-DE-MONTRÃAL,HÃPITAL JEAN-TALON,51228500,12376,1512,889,8.1793476846,9166,3.7848670812,9254,442,366,5.708829215,6060,4.9263613861,3122,690,34,15.502274628,3106,1.5577403949,1070,523
2022-2023,4,06,MontrÃ©al,INSTITUT DE CARDIOLOGIE DE MONTRÃAL,INSTITUT DE CARDIOLOGIE DE MONTRÃAL,51248201,5358,1498,166,9.9881793061,5224,1.2666774077,3259,596,139,3.574715233,3129,1.4715389191,2099,710,102,19.946006564,2095,0.9607052506,902,27
2022-2023,4,07,Outaouais,CISSS DE L'OUTAOUAIS,CENTRE MULTISERVICES DE SANTÃ ET DE SERVICES SOCIAUX DE MANSFIELD-ET-PONTEFRACT,51245058,3343,357,78,4.0037683219,3112,1.500922058,3254,336,75,3.8883529673,3023,1.5040257103,89,0,0,8.2235611735,89,1.3955024969,21,3
2022-2023,4,07,Outaouais,CISSS DE L'OUTAOUAIS,CLSC ET CENTRE D'HÃBERGEMENT DE LA PETITE-NATION,51219491,3302,428,102,2.9720342049,2728,1.3549763767,3038,350,94,2.785902092,2464,1.4170318137,264,0,0,5.1139635943,264,0.775792298,78,8
2022-2023,4,07,Outaouais,CISSS DE L'OUTAOUAIS,HÃPITAL DE GATINEAU,51221703,11607,1492,1457,10.828602113,7522,3.5215604966,7563,556,420,4.9046686353,3553,3.9534852394,4044,1238,501,21.907412422,3969,3.1349067775,936,1037
2022-2023,4,07,Outaouais,CISSS DE L'OUTAOUAIS,HÃPITAL DE HULL,51221711,10139,1681,382,11.492919913,6936,3.1259206395,6835,560,250,4.8796565472,3674,3.6214830944,3304,1103,593,25.173808263,3262,2.5677672185,1121,132
2022-2023,4,07,Outaouais,CISSS DE L'OUTAOUAIS,HÃPITAL DE MANIWAKI,51221893,4211,569,194,5.6956476424,3717,2.4088764087,2780,267,112,3.6347579936,2340,2.5170411918,1431,134,47,9.6993326345,1377,2.2250669733,302,82
2022-2023,4,07,Outaouais,CISSS DE L'OUTAOUAIS,HÃPITAL ET CHSLD DE PAPINEAU,51228823,6794,793,305,8.2620802669,4781,3.03910142,5212,326,127,3.4559770188,3215,3.2696791947,1582,518,262,24.096094255,1566,2.5657249539,467,178
2022-2023,4,07,Outaouais,CISSS DE L'OUTAOUAIS,HÃPITAL ET CHSLD DU PONTIAC,51219459,3253,324,97,4.5351828227,2940,2.086186319,2645,221,71,3.8994239656,2336,2.0878116676,608,16,0,7.3009429825,604,2.0799002024,103,26
2022-2023,4,07,Outaouais,CISSS DE L'OUTAOUAIS,HÃPITAL ET CHSLD MÃMORIAL DE WAKEFIELD / WAKEFIELD MEMORIAL HOSPITAL,51228799,4743,350,129,5.1244319699,3930,2.7140431863,4087,245,99,4.0398225403,3292,2.7584547556,656,87,17,11.881747121,638,2.4848850575,105,30
2022-2023,4,08,Abitibi-TÃ©miscamingue,CISSS DE L'ABITIBI-TÃMISCAMINGUE,CENTRE MULTISERVICES DE SANTÃ ET DE SERVICES SOCIAUX DE LA SARRE,51247559,5629,637,256,5.6638712718,5024,2.4679416025,4781,398,206,4.5116325037,4184,2.6297568781,848,86,39,12.160160836,840,1.6619474206,239,50
2022-2023,4,08,Abitibi-TÃ©miscamingue,CISSS DE L'ABITIBI-TÃMISCAMINGUE,CENTRE MULTISERVICES DE SANTÃ ET DE SERVICES SOCIAUX DE TÃMISCAMING-KIPAWA,51247476,1373,93,96,2.5770292142,1340,0.7709767828,1365,90,93,2.4963597884,1332,0.7687812813,8,1,0,16.34125,8,1.1365277778,3,3
2022-2023,4,08,Abitibi-TÃ©miscamingue,CISSS DE L'ABITIBI-TÃMISCAMINGUE,CENTRE MULTISERVICES DE SANTÃ ET DE SERVICES SOCIAUX DE VILLE-MARIE,51247542,3676,465,186,5.619664566,3140,3.2273932236,3227,311,141,5.0202705471,2696,3.3562423755,449,23,2,9.9275587726,444,2.4450118869,154,45
2022-2023,4,08,Abitibi-TÃ©miscamingue,CISSS DE L'ABITIBI-TÃMISCAMINGUE,HÃPITAL D'AMOS,51228906,6734,606,258,4.1823341748,5971,1.521280262,5252,257,195,2.6733274097,4499,1.6850882912,1482,122,17,9.5300423602,1472,1.0206197162,349,63
2022-2023,4,08,Abitibi-TÃ©miscamingue,CISSS DE L'ABITIBI-TÃMISCAMINGUE,HÃPITAL DE ROUYN-NORANDA,51228922,8436,957,491,6.7167657131,6193,3.6676634013,6947,505,309,5.4843203701,4713,4.1404550062,1489,169,14,12.466797814,1480,2.1620777027,452,182
2022-2023,4,08,Abitibi-TÃ©miscamingue,CISSS DE L'ABITIBI-TÃMISCAMINGUE,HÃPITAL DE VAL-D'OR,51225589,8376,901,569,7.3521002136,6565,4.1074609461,6833,478,405,5.6054283542,5023,4.7152552702,1543,330,26,15.087037877,1542,2.1275965557,423,164
2022-2023,4,09,CÃ´te-Nord,CISSS DE LA CÃTE-NORD,CENTRE MULTISERVICES DE SANTÃ ET DE SERVICES SOCIAUX DE FERMONT,51245108,2020,11,89,9.2366485149,1666,1.6691678338,1936,10,86,9.4471979741,1582,1.7055306223,84,0,0,4.3839847884,84,0.9843353175,1,3
2022-2023,4,09,CÃ´te-Nord,CISSS DE LA CÃTE-NORD,CENTRE MULTISERVICES DE SANTÃ ET DE SERVICES SOCIAUX DE FORESTVILLE,51218741,3460,482,123,3.3571502087,2828,2.0398962753,3100,378,103,2.9901159498,2506,2.1542013612,360,10,0,6.5177229938,322,1.1503045204,104,20
2022-2023,4,09,CÃ´te-Nord,CISSS DE LA CÃTE-NORD,CENTRE MULTISERVICES DE SANTÃ ET DE SERVICES SOCIAUX DE LA BASSE-CÃTE-NORD,51245140,1002,134,49,3.0312613662,966,1.0580247872,822,96,46,2.8460421736,786,1.0965882103,180,0,0,3.877095679,180,0.8896311728,38,3
2022-2023,4,09,CÃ´te-Nord,CISSS DE LA CÃTE-NORD,CENTRE MULTISERVICES DE SANTÃ ET DE SERVICES SOCIAUX DE LA MINGANIE,51245116,3770,337,110,2.9822259063,2239,2.281218674,2584,214,52,1.8251245915,1100,2.4062780303,1186,29,3,5.5032628349,1139,2.1604414203,123,58
2022-2023,4,09,CÃ´te-Nord,CISSS DE LA CÃTE-NORD,CENTRE MULTISERVICES DE SANTÃ ET DE SERVICES SOCIAUX DE PORT-CARTIER,51245132,4636,302,192,5.3451226512,3710,3.1061457772,4244,216,161,4.4297777254,3328,3.2726029147,392,70,19,15.255132511,382,1.6559642234,86,31
2022-2023,4,09,CÃ´te-Nord,CISSS DE LA CÃTE-NORD,CENTRE MULTISERVICES DE SANTÃ ET DE SERVICES SOCIAUX DES ESCOUMINS,51218733,3056,442,77,3.4898711097,2665,1.4545160517,2687,304,68,2.890526713,2301,1.5158614612,369,9,0,7.8542028004,364,1.0667254274,138,9
2022-2023,4,09,CÃ´te-Nord,CISSS DE LA CÃTE-NORD,CLSC ET HÃPITAL LE ROYER,51228765,6742,1003,452,9.0783949702,5706,3.481450666,5017,435,267,5.2121099927,3983,3.995713658,1725,468,203,20.323120612,1723,2.2926465467,568,185
2022-2023,4,09,CÃ´te-Nord,CISSS DE LA CÃTE-NORD,HÃPITAL ET CLSC DE SEPT-ÃLES,51232023,6731,671,398,9.7019084584,4998,4.1841951781,4655,228,181,5.3942700203,2993,4.5862890262,2076,492,210,19.360895419,2005,3.5839623164,443,217
2022-2023,4,11,GaspÃ©sie-Ãles-de-la-Madeleine,CISSS DE LA GASPÃSIE,CENTRE MULTISERVICES DE SANTÃ ET DE SERVICES SOCIAUX DE GRANDE-VALLÃE,51247732,1783,358,32,1.7671650464,1404,0.806662314,1623,296,28,1.3373129322,1261,0.8246400564,160,7,2,6.1274774306,143,0.6481313131,62,4
2022-2023,4,11,GaspÃ©sie-Ãles-de-la-Madeleine,CISSS DE LA GASPÃSIE,CLSC ET CENTRE DE SERVICES AMBULATOIRES DE MURDOCHVILLE,51221307,560,54,27,3.0064246032,544,1.4676256127,546,51,27,2.8576561864,530,1.4815870021,14,2,0,8.8083928571,14,0.9390873016,3,0
2022-2023,4,11,GaspÃ©sie-Ãles-de-la-Madeleine,CISSS DE LA GASPÃSIE,CLSC ET CENTRE DE SERVICES AMBULATOIRES DE PASPÃBIAC,51220978,4154,674,154,3.9465309875,3686,1.9365021553,3233,416,118,3.2133511187,2820,2.0535849094,921,29,3,6.5202231874,866,1.5552396074,258,36
2022-2023,4,11,GaspÃ©sie-Ãles-de-la-Madeleine,CISSS DE LA GASPÃSIE,HÃPITAL DE CHANDLER,51227775,4760,747,190,5.7783793184,4175,2.0684546906,4045,477,159,3.926367944,3463,2.2331153143,715,141,34,16.255842269,712,1.2675842697,270,31
2022-2023,4,11,GaspÃ©sie-Ãles-de-la-Madeleine,CISSS DE LA GASPÃSIE,HÃPITAL DE GASPÃ,51220903,4296,700,194,5.0540700652,3723,1.6618946041,3469,415,124,3.5430782166,2911,1.8714525364,827,94,3,11.392196695,812,0.9106345785,285,70
2022-2023,4,11,GaspÃ©sie-Ãles-de-la-Madeleine,CISSS DE LA GASPÃSIE,HÃPITAL ET CLSC DE SAINTE-ANNE-DES-MONTS,51247799,4211,750,201,5.6490497111,3619,2.0506292407,3365,428,136,3.1186802873,2787,2.146951521,846,165,64,15.713698779,832,1.7279727564,322,65
2022-2023,4,11,GaspÃ©sie-Ãles-de-la-Madeleine,CISSS DE LA GASPÃSIE,HÃPITAL ET GROUPE DE MÃDECINE DE FAMILLE UNIVERSITAIRE DE MARIA,51227908,4928,858,269,9.0127495942,4540,2.0999260279,3695,424,144,4.0257982258,3314,2.2919218132,1233,420,204,23.95742543,1226,1.5809423147,434,125
2022-2023,4,11,GaspÃ©sie-Ãles-de-la-Madeleine,CISSS DES ÃLES,HÃPITAL DE L'ARCHIPEL,51227783,5448,615,148,4.4810349364,4768,2.0394405994,4656,416,87,3.4643596077,3983,2.1574517393,792,63,1,10.457853535,785,1.4406656051,199,61
2022-2023,4,12,ChaudiÃ¨re-Appalaches,CISSS DE CHAUDIÃRE-APPALACHES,CHSLD ET HÃPITAL PAUL-GILBERT,51245199,14167,1015,204,2.544569069,10440,1.924695961,13387,941,193,2.484912083,9660,2.0201241086,780,0,0,3.5684512108,780,0.742855057,74,11
2022-2023,4,12,ChaudiÃ¨re-Appalaches,CISSS DE CHAUDIÃRE-APPALACHES,HÃPITAL DE MONTMAGNY,51245223,10340,1551,335,4.5279678702,9421,1.4800602967,8056,729,159,2.4441059804,7138,1.6928747159,2284,269,10,11.878051664,2283,0.8146773252,822,176
2022-2023,4,12,ChaudiÃ¨re-Appalaches,CISSS DE CHAUDIÃRE-APPALACHES,HÃPITAL DE SAINT-GEORGES,51228971,13249,2280,625,7.0590090657,10717,2.5644242533,9250,803,290,4.212612012,6730,3.237639508,3999,643,42,13.642948237,3987,1.428046359,1477,335
2022-2023,4,12,ChaudiÃ¨re-Appalaches,CISSS DE CHAUDIÃRE-APPALACHES,HÃPITAL DE THETFORD,51245231,12041,1845,340,6.705875135,10834,1.7965886971,9600,941,186,4.6854956887,8397,2.015539313,2441,504,43,14.651652556,2437,1.0421659144,904,154
2022-2023,4,12,ChaudiÃ¨re-Appalaches,CISSS DE CHAUDIÃRE-APPALACHES,HÃTEL-DIEU DE LÃVIS,51227569,23529,4363,1456,7.8141704917,20874,1.328361851,16412,1608,653,3.149758747,13759,1.6790383466,7117,2063,446,18.570433742,7115,0.650223003,2755,803
2022-2023,4,13,Laval,CISSS DE LAVAL,HÃPITAL DE LA CITÃ-DE-LA-SANTÃ,51228757,28821,4788,1795,8.7517344799,21357,3.1129045252,19510,1435,564,5.3394210804,12077,3.9861801128,9311,1851,111,15.901797247,9280,1.9764229227,3353,1231
2022-2023,4,14,LanaudiÃ¨re,CISSS DE LANAUDIÃRE,HÃPITAL DE LANAUDIÃRE ET CENTRE D'HÃBERGEMENT PARPHILIA-FERLAND,51244945,20826,3391,1363,9.915551274,16912,2.4818530563,13859,1013,983,5.4484407846,9984,3.2505692441,6967,2000,583,18.801683651,6928,1.3740495894,2378,380
2022-2023,4,14,LanaudiÃ¨re,CISSS DE LANAUDIÃRE,HÃPITAL PIERRE-LE GARDEUR,51228062,23458,3967,1303,10.483954822,14473,5.1670214844,16346,1371,481,6.4985882207,7383,6.6312745873,7112,2412,209,19.643797689,7090,3.6422569346,2596,822
2022-2023,4,15,Laurentides,CISSS DES LAURENTIDES,CENTRE MULTISERVICES DE SANTÃ ET DE SERVICES SOCIAUX D'ARGENTEUIL,51245306,6320,753,207,9.1146501846,4916,3.7079214696,5219,440,136,5.8309977965,3821,4.2259851988,1101,432,169,24.679937935,1095,1.9001392694,313,71
2022-2023,4,15,Laurentides,CISSS DES LAURENTIDES,CENTRE MULTISERVICES DE SANTÃ ET DE SERVICES SOCIAUX DE RIVIÃRE-ROUGE,51217628,4509,486,203,6.0448463567,3871,2.7084087517,3610,249,97,3.7232717759,2986,2.8453472687,899,169,51,15.367298233,885,2.2463766478,237,106
2022-2023,4,15,Laurentides,CISSS DES LAURENTIDES,CENTRE MULTISERVICES DE SANTÃ ET DE SERVICES SOCIAUX DE SAINTE-AGATHE,51246874,9194,1643,508,12.156317103,7182,3.9624335917,6162,629,160,6.6339607451,4181,4.9567348322,3032,1082,374,23.379522867,3001,2.5771708505,1014,348
2022-2023,4,15,Laurentides,CISSS DES LAURENTIDES,HÃPITAL DE MONT-LAURIER,51217610,5203,700,271,9.0447287356,4186,2.8729625206,4077,365,146,5.4099058404,3077,3.0812580797,1126,349,154,22.20562833,1109,2.29503156,335,125
2022-2023,4,15,Laurentides,CISSS DES LAURENTIDES,HÃPITAL DE SAINT-EUSTACHE,51228864,14876,2614,828,12.860954539,10124,3.5332938233,9438,767,257,6.3626796814,4712,5.2070835691,5438,2123,826,24.139129991,5412,2.0759957297,1847,571
2022-2023,4,15,Laurentides,CISSS DES LAURENTIDES,HÃPITAL DE SAINT-JÃRÃME,51228880,17393,2855,1715,14.791505235,11746,4.8275200068,10414,868,492,7.050860727,4819,6.700374559,6979,2676,1082,26.342024208,6927,3.52460589,1987,1223
2022-2023,4,16,MontÃ©rÃ©gie,CISSS DE LA MONTÃRÃGIE-CENTRE,HÃPITAL CHARLES-LE MOYNE,51233799,23669,3867,1912,9.9732899691,12716,5.363325928,16821,1429,823,6.1348448864,5873,6.4792632007,6848,2187,200,19.401807016,6843,4.4055735382,2438,1089
2022-2023,4,16,MontÃ©rÃ©gie,CISSS DE LA MONTÃRÃGIE-CENTRE,HÃPITAL DU HAUT-RICHELIEU,51229045,18605,2746,1064,10.365342948,13517,2.905689235,13524,1039,399,4.8803368086,8469,3.46383231,5081,1592,945,24.964678322,5048,1.9692958708,1707,665
2022-2023,4,16,MontÃ©rÃ©gie,CISSS DE LA MONTÃRÃGIE-EST,HÃPITAL HONORÃ-MERCIER,51229193,14343,2614,841,10.119196065,10310,4.0690949995,10606,1095,436,5.5517367004,6579,5.0763901555,3737,1328,508,23.082127301,3731,2.2928969743,1519,405
2022-2023,4,16,MontÃ©rÃ©gie,CISSS DE LA MONTÃRÃGIE-EST,HÃPITAL PIERRE-BOUCHER,51229011,17094,3247,1039,13.963367263,12180,4.8228530378,8798,923,314,5.9570358478,3981,6.2855720924,8296,2441,1130,22.454170517,8199,4.1126341627,2324,725
2022-2023,4,16,MontÃ©rÃ©gie,CISSS DE LA MONTÃRÃGIE-EST,HÃTEL-DIEU DE SOREL,51229102,10359,1644,557,9.0588244522,8789,2.3723241489,7150,676,172,4.8498675214,5603,2.8768633371,3209,872,272,18.436836934,3186,1.485025633,968,385
2022-2023,4,16,MontÃ©rÃ©gie,CISSS DE LA MONTÃRÃGIE-OUEST,HÃPITAL ANNA-LABERGE,51229151,11504,2252,583,17.019937799,8463,2.1945711397,7576,673,148,7.8325652646,4536,3.1370750049,3928,1966,1016,34.739778513,3927,1.1059035736,1579,435
2022-2023,4,16,MontÃ©rÃ©gie,CISSS DE LA MONTÃRÃGIE-OUEST,HÃPITAL BARRIE MEMORIAL / BARRIE MEMORIAL HOSPITAL,51228005,6608,633,105,5.5911220827,5186,3.0276197669,5631,373,85,3.9315530101,4215,2.7846312772,977,201,17,15.1561512,971,4.0824050235,260,20
2022-2023,4,16,MontÃ©rÃ©gie,CISSS DE LA MONTÃRÃGIE-OUEST,HÃPITAL DU SUROÃT,51229136,11313,2184,805,13.191816151,9030,2.2277115787,7434,665,473,4.4129272412,5170,2.9410794111,3879,1498,854,30.016322506,3860,1.272242228,1519,332
2023-2024,4,01,Bas-Saint-Laurent,CISSS DU BAS-SAINT-LAURENT,CENTRE HOSPITALIER RÃGIONAL DU GRAND-PORTAGE,51218352,6020,1108,305,4.843017488,5194,2.0858339216,4385,488,175,3.3407929811,3568,2.3321686597,1635,15,0,8.8719193,1626,1.5452912737,620,130
2023-2024,4,01,Bas-Saint-Laurent,CISSS DU BAS-SAINT-LAURENT,CENTRE MULTISERVICES DE SANTÃ ET DE SERVICES SOCIAUX DE TROIS-PISTOLES,51236156,3215,526,83,3.4617427856,2902,1.3589754193,2696,339,60,2.5321045582,2391,1.4534186068,519,16,0,8.2908461785,511,0.9170700152,187,23
2023-2024,4,01,Bas-Saint-Laurent,CISSS DU BAS-SAINT-LAURENT,CLSC DE POHÃNÃGAMOOK,51219418,3135,443,102,1.8305629098,2902,0.9305069301,2946,395,93,1.5415386211,2713,0.9421648851,189,1,0,6.3356716637,189,0.7631628454,48,9
2023-2024,4,01,Bas-Saint-Laurent,CISSS DU BAS-SAINT-LAURENT,HÃPITAL D'AMQUI,51226892,4373,708,129,4.1375556445,3850,1.615326912,2466,263,70,3.1588751464,2017,1.8296727814,1907,21,0,5.4031173163,1833,1.3794645996,445,59
2023-2024,4,01,Bas-Saint-Laurent,CISSS DU BAS-SAINT-LAURENT,HÃPITAL DE MATANE,51218980,5039,912,216,5.2420313775,4400,2.6625559343,3731,462,120,4.4913853152,3120,3.0375219907,1308,42,6,7.3832090979,1280,1.7485761719,450,96
2023-2024,4,01,Bas-Saint-Laurent,CISSS DU BAS-SAINT-LAURENT,HÃPITAL DE NOTRE-DAME-DU-LAC,51221877,3788,674,117,3.5354097736,3368,1.3822592538,3007,389,65,2.276923752,2595,1.5356642047,781,25,0,8.3808226633,773,0.8672710939,285,52
2023-2024,4,01,Bas-Saint-Laurent,CISSS DU BAS-SAINT-LAURENT,HÃPITAL NOTRE-DAME-DE-FATIMA,51221141,4724,876,155,3.5472998401,4375,1.3801336508,3667,463,69,2.5677910341,3324,1.4918277845,1057,1,0,6.9454633134,1051,1.0268783698,413,86
2023-2024,4,01,Bas-Saint-Laurent,CISSS DU BAS-SAINT-LAURENT,HÃPITAL RÃGIONAL DE RIMOUSKI,51227882,9141,1710,497,5.8245484022,7329,2.438451206,6493,720,287,4.1516467307,4708,2.8239038752,2648,155,2,9.9265690039,2621,1.7460776209,990,210
2023-2024,4,02,Saguenay-Lac-Saint-Jean,CIUSSS DU SAGUENAY - LAC-SAINT-JEAN,HÃPITAL D'ALMA,51219400,10241,1545,435,4.7661697263,8172,2.7691438584,7762,821,202,3.6521675757,5744,2.9912267874,2479,40,0,8.2542232531,2428,2.2437549195,724,233
2023-2024,4,02,Saguenay-Lac-Saint-Jean,CIUSSS DU SAGUENAY - LAC-SAINT-JEAN,HÃPITAL DE CHICOUTIMI,51218394,15980,2550,1030,7.2027290189,14033,2.4097489449,9227,790,349,3.7465216815,7332,3.1680214584,6753,886,69,11.925137593,6701,1.5800736623,1760,681
2023-2024,4,02,Saguenay-Lac-Saint-Jean,CIUSSS DU SAGUENAY - LAC-SAINT-JEAN,HÃPITAL DE DOLBEAU-MISTASSINI,51219384,6023,1029,206,4.3035648532,5459,1.8214203354,5008,649,103,2.9726600772,4457,1.9698345923,1015,66,14,10.870235906,1002,1.1612583167,380,103
2023-2024,4,02,Saguenay-Lac-Saint-Jean,CIUSSS DU SAGUENAY - LAC-SAINT-JEAN,HÃPITAL DE LA BAIE,51221364,5445,733,170,5.1504890827,4942,2.6054062121,4244,353,102,3.9087992853,3751,2.8679350692,1201,33,0,9.5382755111,1191,1.7785835899,380,68
2023-2024,4,02,Saguenay-Lac-Saint-Jean,CIUSSS DU SAGUENAY - LAC-SAINT-JEAN,HÃPITAL ET CENTRE D'HÃBERGEMENT DE ROBERVAL,51228203,7120,1045,459,5.5661692806,6419,2.1175776341,4892,456,164,3.3284763105,4232,2.3270519586,2228,205,22,10.47945205,2187,1.71222997,589,295
2023-2024,4,02,Saguenay-Lac-Saint-Jean,CIUSSS DU SAGUENAY - LAC-SAINT-JEAN,HÃPITAL ET CENTRE DE RÃADAPTATION DE JONQUIÃRE,51224541,7697,1373,381,7.4820942864,6104,4.1527917941,4619,507,131,5.02694252,3153,4.5690234169,3078,183,1,11.166417226,2951,3.7080685455,866,250
2023-2024,4,03,Capitale-Nationale,CHU DE QUÃBEC - UNIVERSITÃ LAVAL,CENTRE HOSPITALIER DE L'UNIVERSITÃ LAVAL,51217594,20850,1727,2007,8.3785753397,16757,2.2633401133,11688,346,637,4.9501875143,7624,3.5474036668,9162,981,383,12.752183384,9133,1.1914359709,1381,1370
2023-2024,4,03,Capitale-Nationale,CHU DE QUÃBEC - UNIVERSITÃ LAVAL,HÃPITAL DE L'ENFANT-JÃSUS,51233914,18341,3167,2288,9.9014335672,16581,1.5982775633,10204,1054,613,4.0046928764,8492,2.0279884336,8137,1715,493,17.296092779,8089,1.1471581778,2113,1675
2023-2024,4,03,Capitale-Nationale,CHU DE QUÃBEC - UNIVERSITÃ LAVAL,HÃPITAL DU SAINT-SACREMENT,51217529,10356,2478,284,7.4357751545,8603,1.8700936043,7200,980,112,3.4045150463,5461,2.2223038617,3156,780,103,16.632566276,3142,1.257929309,1498,172
2023-2024,4,03,Capitale-Nationale,CHU DE QUÃBEC - UNIVERSITÃ LAVAL,HÃPITAL SAINT-FRANÃOIS D'ASSISE,51217602,12297,3013,400,9.9367589656,9940,2.2029230941,7386,870,190,4.3842664049,5040,2.9698280423,4911,1381,199,18.287544967,4900,1.414106576,2143,210
2023-2024,4,03,Capitale-Nationale,CHU DE QUÃBEC - UNIVERSITÃ LAVAL,L'HÃTEL-DIEU DE QUÃBEC,51217586,6198,1419,315,7.2723533129,5591,1.473570371,3167,334,103,3.0596849454,2592,1.6797003601,3031,259,3,11.674042762,2999,1.2954146753,1085,212
2023-2024,4,03,Capitale-Nationale,CIUSSS DE LA CAPITALE-NATIONALE,CENTRE MULTISERVICES DE SANTÃ ET DE SERVICES SOCIAUX CHAUVEAU,51225001,11585,803,141,2.870194936,7892,1.8915400617,10132,628,99,2.665984203,6459,2.0642307461,1453,0,0,4.294188843,1433,1.1131666279,175,42
2023-2024,4,03,Capitale-Nationale,CIUSSS DE LA CAPITALE-NATIONALE,CENTRE MULTISERVICES DE SANTÃ ET DE SERVICES SOCIAUX DE BAIE-SAINT-PAUL,51244804,3620,704,120,5.7431375077,2822,1.9849962595,2902,451,52,3.079633586,2111,2.1925668456,718,142,45,16.508441659,711,1.3687072199,253,68
2023-2024,4,03,Capitale-Nationale,CIUSSS DE LA CAPITALE-NATIONALE,CENTRE MULTISERVICES DE SANTÃ ET DE SERVICES SOCIAUX DE SAINT-MARC-DES-CARRIÃRES,51247344,4811,679,125,2.8662594402,4080,1.4182148693,3874,373,78,2.2203892044,3168,1.6079571759,937,8,0,5.5365916637,912,0.7591100146,306,47
2023-2024,4,03,Capitale-Nationale,CIUSSS DE LA CAPITALE-NATIONALE,CENTRE MULTISERVICES DE SANTÃ ET DE SERVICES SOCIAUX DE SAINT-RAYMOND,51247302,5869,831,110,4.0058833608,4819,1.8817032118,4743,455,68,3.0308277696,3705,2.1176446244,1126,32,3,8.1130669035,1114,1.0969968083,376,42
2023-2024,4,03,Capitale-Nationale,CIUSSS DE LA CAPITALE-NATIONALE,CENTRE MULTISERVICES DE SANTÃ ET DE SERVICES SOCIAUX DE SAINTE-ANNE-DE-BEAUPRÃ,51225357,4585,511,69,3.8145705804,3541,1.8146296558,3942,302,48,2.9671638762,2908,1.9632738232,643,35,4,9.0097140142,633,1.1317588204,209,21
2023-2024,4,03,Capitale-Nationale,CIUSSS DE LA CAPITALE-NATIONALE,HÃPITAL ET CLSC DE LA MALBAIE,51228690,4159,755,125,5.951758903,3434,1.6596580761,3347,488,76,3.2014659894,2623,1.9028384589,812,185,54,17.288249521,811,0.8731449514,267,49
2023-2024,4,03,Capitale-Nationale,INSTITUT UNIVERSITAIRE DE CARDIOLOGIE ET DE PNEUMOLOGIE DE QUÃBEC - UNIVERSITÃ LAVAL,INSTITUT UNIVERSITAIRE DE CARDIOLOGIE ET DE PNEUMOLOGIE DE QUÃBEC,51232130,8404,2841,191,7.8984896412,7958,1.9375705091,4384,1012,119,3.9587844688,3948,2.4930555556,4020,422,2,12.194924337,4010,1.3906740094,1829,72
2023-2024,4,04,Mauricie et Centre-du-QuÃ©bec,CIUSSS DE LA MAURICIE-ET-DU-CENTRE-DU-QUÃBEC,CENTRE MULTISERVICES DE SANTÃ ET DE SERVICES SOCIAUX AVELLIN-DALCOURT,51233583,6131,910,134,4.60177264,4966,2.8367627646,5221,537,88,3.7859267595,4069,3.1084831791,910,37,2,9.2825763126,897,1.6041759569,373,46
2023-2024,4,04,Mauricie et Centre-du-QuÃ©bec,CIUSSS DE LA MAURICIE-ET-DU-CENTRE-DU-QUÃBEC,CENTRE MULTISERVICES DE SANTÃ ET DE SERVICES SOCIAUX CHRIST-ROI,51246338,6215,653,168,4.9116239832,4948,3.2294439953,5138,303,127,3.9575583344,3901,3.4618477456,1077,58,9,9.4631460848,1047,2.3635347023,350,41
2023-2024,4,04,Mauricie et Centre-du-QuÃ©bec,CIUSSS DE LA MAURICIE-ET-DU-CENTRE-DU-QUÃBEC,CENTRE MULTISERVICES DE SANTÃ ET DE SERVICES SOCIAUX DE FORTIERVILLE,51219160,3371,306,72,2.3113644978,2714,1.869424998,3183,274,65,2.248049534,2528,1.926230661,188,1,0,3.383340721,186,1.0973566308,32,7
2023-2024,4,04,Mauricie et Centre-du-QuÃ©bec,CIUSSS DE LA MAURICIE-ET-DU-CENTRE-DU-QUÃBEC,CENTRE MULTISERVICES DE SANTÃ ET DE SERVICES SOCIAUX DU HAUT-SAINT-MAURICE,51219731,3360,522,166,6.0265277778,2883,2.7910755579,2506,298,72,4.045407134,2048,3.0079399957,854,83,3,11.839980159,835,2.25917332,224,94
2023-2024,4,04,Mauricie et Centre-du-QuÃ©bec,CIUSSS DE LA MAURICIE-ET-DU-CENTRE-DU-QUÃBEC,HÃPITAL DU CENTRE-DE-LA-MAURICIE,51220051,10246,1989,665,7.9325963249,8192,3.0035122342,6469,661,141,4.8767053555,4433,4.1324024989,3777,511,50,13.166527667,3759,1.6722085513,1328,524
2023-2024,4,04,Mauricie et Centre-du-QuÃ©bec,CIUSSS DE LA MAURICIE-ET-DU-CENTRE-DU-QUÃBEC,HÃPITAL SAINTE-CROIX,51228781,11849,1830,720,8.1112310228,8836,3.1165314873,6918,524,162,5.1505504963,4071,4.0366095554,4931,657,22,12.26494992,4765,2.3304584936,1306,558
2023-2024,4,04,Mauricie et Centre-du-QuÃ©bec,CIUSSS DE LA MAURICIE-ET-DU-CENTRE-DU-QUÃBEC,HÃTEL-DIEU D'ARTHABASKA,51228039,11205,2003,585,5.7063141455,9300,2.1517706093,6822,643,156,3.6972289407,4982,2.6843910299,4383,210,3,8.8333913225,4318,1.537246539,1360,429
2023-2024,4,04,Mauricie et Centre-du-QuÃ©bec,CIUSSS DE LA MAURICIE-ET-DU-CENTRE-DU-QUÃBEC,PAVILLON SAINTE-MARIE,51220168,17248,3877,994,9.9750566893,13129,3.230441622,9251,886,272,5.1673518779,5224,4.7049844734,7997,1767,119,15.536651939,7905,2.2559935695,2991,722
2023-2024,4,05,Estrie,CIUSSS DE L'ESTRIE - CENTRE HOSPITALIER UNIVERSITAIRE DE SHERBROOKE,CENTRE DE SANTÃ ET DE SERVICES SOCIAUX DU GRANIT,51223832,4501,712,129,5.7505603693,3751,3.1865661749,3674,425,81,4.5098692766,2931,3.450274366,827,74,3,11.262409311,820,2.2439701897,287,48
2023-2024,4,05,Estrie,CIUSSS DE L'ESTRIE - CENTRE HOSPITALIER UNIVERSITAIRE DE SHERBROOKE,CENTRE MULTISERVICES DE SANTÃ ET DE SERVICES SOCIAUX DE LA MRC DE COATICOOK,51247617,5661,503,151,2.8410623859,4583,1.9870533008,4539,321,110,2.6417924286,3478,2.1772514536,1122,0,0,3.6471999406,1105,1.3884024635,182,41
2023-2024,4,05,Estrie,CIUSSS DE L'ESTRIE - CENTRE HOSPITALIER UNIVERSITAIRE DE SHERBROOKE,CENTRE MULTISERVICES DE SANTÃ ET DE SERVICES SOCIAUX DE MEMPHRÃMAGOG,51219046,7166,1424,238,6.2475435699,6069,2.8897697314,5348,695,121,4.2096105502,4279,3.1781085274,1818,251,56,12.242519252,1790,2.2004950341,729,117
2023-2024,4,05,Estrie,CIUSSS DE L'ESTRIE - CENTRE HOSPITALIER UNIVERSITAIRE DE SHERBROOKE,CENTRE MULTISERVICES DE SANTÃ ET DE SERVICES SOCIAUX DES SOURCES,51247583,5109,667,165,5.1684364194,4221,3.4973179736,4458,437,112,4.57313444,3577,3.7611316901,651,34,0,9.2450204813,644,2.0320048309,230,53
2023-2024,4,05,Estrie,CIUSSS DE L'ESTRIE - CENTRE HOSPITALIER UNIVERSITAIRE DE SHERBROOKE,CHUS - HÃPITAL FLEURIMONT,51216687,13395,1986,299,8.8931019037,11381,2.7937351727,6956,401,116,6.1828493387,4947,4.8917357321,6439,814,46,11.820965989,6434,1.1806159983,1585,183
2023-2024,4,05,Estrie,CIUSSS DE L'ESTRIE - CENTRE HOSPITALIER UNIVERSITAIRE DE SHERBROOKE,CHUS - HÃTEL-DIEU DE SHERBROOKE,51216695,13914,2747,1747,11.048027167,11759,2.7560336763,6888,713,358,5.4191807007,4741,4.2351648738,7026,1580,398,16.56631559,7018,1.7568086824,2034,1389
2023-2024,4,05,Estrie,CIUSSS DE L'ESTRIE - CENTRE HOSPITALIER UNIVERSITAIRE DE SHERBROOKE,HÃPITAL BROME-MISSISQUOI-PERKINS,51229185,8186,1336,269,10.327011734,6512,4.079270748,5686,495,96,5.6830538946,4046,4.7013353381,2500,788,281,20.889229444,2466,3.0586408489,841,173
2023-2024,4,05,Estrie,CIUSSS DE L'ESTRIE - CENTRE HOSPITALIER UNIVERSITAIRE DE SHERBROOKE,HÃPITAL DE GRANBY,51228120,11154,1896,794,10.940730331,8674,4.6358992711,7506,721,269,6.9545526172,5057,5.815405159,3648,1168,183,19.142553226,3617,2.9868085123,1175,525
2023-2024,4,06,MontrÃ©al,CENTRE HOSPITALIER DE L'UNIVERSITÃ DE MONTRÃAL,CENTRE HOSPITALIER DE L'UNIVERSITÃ DE MONTRÃAL,51236297,21286,3057,1663,12.496204991,16245,2.9962580794,12386,809,514,7.2831363143,7413,4.915733059,8900,2835,450,19.751156523,8832,1.3851770079,2248,1149
2023-2024,4,06,MontrÃ©al,CENTRE HOSPITALIER UNIVERSITAIRE SAINTE-JUSTINE,CHU SAINTE-JUSTINE,51222800,23557,0,547,5.2167313325,20335,2.0987922438,15028,0,214,4.4746336283,12111,2.6614739585,8529,116,0,6.5242989604,8224,1.2701640524,0,333
2023-2024,4,06,MontrÃ©al,CENTRE UNIVERSITAIRE DE SANTÃ MCGILL,HÃPITAL DE LACHINE,51228310,5778,459,78,5.9238772066,5023,3.4593588935,5110,315,54,4.801681072,4358,3.5666749528,668,113,25,14.50834165,665,2.7560756057,144,24
2023-2024,4,06,MontrÃ©al,CENTRE UNIVERSITAIRE DE SANTÃ MCGILL,HÃPITAL GÃNÃRAL DE MONTRÃAL,51248219,9539,1405,1254,16.832097908,8097,1.9793814582,4045,313,269,6.2201632331,2660,3.0021717836,5494,1696,815,24.645216903,5437,1.4789911205,1092,985
2023-2024,4,06,MontrÃ©al,CENTRE UNIVERSITAIRE DE SANTÃ MCGILL,HÃPITAL ROYAL VICTORIA,51223295,13802,2311,355,17.167108571,10310,4.4453520584,8276,649,146,8.6574030664,4929,5.7886202971,5526,2249,1076,29.911647615,5381,3.2149173532,1662,209
2023-2024,4,06,MontrÃ©al,CENTRE UNIVERSITAIRE DE SANTÃ MCGILL,L'HÃPITAL DE MONTRÃAL POUR ENFANTS,51223279,20636,3,688,6.0022614875,19146,1.5901358857,15924,0,222,4.7919568471,14448,1.8062569214,4712,329,19,10.092433621,4698,0.9254877962,3,466
2023-2024,4,06,MontrÃ©al,CIUSSS DE L'EST-DE-L'ÃLE-DE-MONTRÃAL,HÃPITAL MAISONNEUVE-ROSEMONT,12934659,19273,3454,1280,10.903676992,14932,3.0784361327,11419,908,322,5.3233133131,7123,4.3150159499,7854,2321,476,19.017017054,7809,1.9504865824,2546,958
2023-2024,4,06,MontrÃ©al,CIUSSS DE L'EST-DE-L'ÃLE-DE-MONTRÃAL,HÃPITAL SANTA CABRINI,51235919,10172,2545,357,14.988355016,7965,3.0789783427,6027,670,139,6.8613897185,3837,4.4041167144,4145,1561,791,26.805295872,4128,1.847254522,1875,218
2023-2024,4,06,MontrÃ©al,CIUSSS DE L'EST-DE-L'ÃLE-DE-MONTRÃAL,INSTITUT UNIVERSITAIRE EN SANTÃ MENTALE DE MONTRÃAL,51235307,1529,64,1525,14.182410435,1494,1.7094210174,694,28,690,3.4503942523,659,1.5875547968,835,316,81,23.102193945,835,1.8056004657,36,835
2023-2024,4,06,MontrÃ©al,CIUSSS DE L'OUEST-DE-L'ÃLE-DE-MONTRÃAL,CENTRE HOSPITALIER DE ST. MARY,51248243,9575,1914,726,11.253660313,8762,2.2621215349,6251,658,254,5.252382641,5448,2.6954798397,3324,1178,309,22.539456562,3314,1.5497087273,1256,472
2023-2024,4,06,MontrÃ©al,CIUSSS DE L'OUEST-DE-L'ÃLE-DE-MONTRÃAL,HÃPITAL DE LASALLE,51224392,7787,1257,259,10.793932373,6100,3.586356102,5902,512,87,6.4533969182,4227,4.2990349736,1885,616,256,24.384298556,1873,1.9779772498,745,172
2023-2024,4,06,MontrÃ©al,CIUSSS DE L'OUEST-DE-L'ÃLE-DE-MONTRÃAL,HÃPITAL DOUGLAS,51235190,1521,34,1461,16.096589415,1397,1.9217062356,849,19,795,3.5419022379,725,1.9545383142,672,354,140,31.958091518,672,1.8862847222,15,666
2023-2024,4,06,MontrÃ©al,CIUSSS DE L'OUEST-DE-L'ÃLE-DE-MONTRÃAL,HÃPITAL GÃNÃRAL DU LAKESHORE,51228278,11341,2565,939,14.691848162,9499,2.3926335813,6968,721,98,6.889858799,5139,3.0977500486,4373,1778,751,27.123648271,4360,1.5615341488,1844,841
2023-2024,4,06,MontrÃ©al,CIUSSS DU CENTRE-OUEST-DE-L'ÃLE-DE-MONTRÃAL,HÃPITAL GÃNÃRAL JUIF,51248250,26330,5114,1455,10.940234639,22617,2.5148945606,9111,616,157,4.0594895669,5914,3.0678103277,17219,2640,697,14.581007527,16703,2.3191247081,4498,1298
2023-2024,4,06,MontrÃ©al,CIUSSS DU CENTRE-SUD-DE-L'ÃLE-DE-MONTRÃAL,HÃPITAL DE VERDUN,51218097,12655,2269,817,9.0922137715,11075,2.0931104841,8313,697,300,4.1746797185,6743,2.617781197,4342,1376,93,18.50710566,4332,1.2764312096,1572,517
2023-2024,4,06,MontrÃ©al,CIUSSS DU CENTRE-SUD-DE-L'ÃLE-DE-MONTRÃAL,HÃPITAL NOTRE-DAME,51236313,11161,1523,1746,12.816561265,9374,2.2622119693,6374,317,617,5.4757996897,4605,3.1988047412,4787,1694,403,22.590953218,4769,1.3578274621,1206,1129
2023-2024,4,06,MontrÃ©al,CIUSSS DU NORD-DE-L'ÃLE-DE-MONTRÃAL,HÃPITAL DU SACRÃ-COEUR-DE-MONTRÃAL,12475976,19208,3722,933,12.443436386,15033,3.1265273435,13086,1171,388,6.7373760125,8921,4.3682341292,6122,2617,942,24.640350149,6112,1.3141473967,2551,545
2023-2024,4,06,MontrÃ©al,CIUSSS DU NORD-DE-L'ÃLE-DE-MONTRÃAL,HÃPITAL EN SANTÃ MENTALE ALBERT-PRÃVOST,51848752,1018,33,1014,22.482878193,1005,0.3770351023,453,13,449,3.8753256071,440,0.5028832071,565,323,155,37.401853982,565,0.2790294985,20,565
2023-2024,4,06,MontrÃ©al,CIUSSS DU NORD-DE-L'ÃLE-DE-MONTRÃAL,HÃPITAL FLEURY,51228492,9100,1457,275,9.301957265,6656,4.0040231036,6603,576,132,6.0949726135,4172,5.0957481091,2497,684,30,17.782421684,2484,2.1704173376,881,143
2023-2024,4,06,MontrÃ©al,CIUSSS DU NORD-DE-L'ÃLE-DE-MONTRÃAL,HÃPITAL JEAN-TALON,51228500,12564,1515,1043,7.4300428473,9386,3.0020725312,9421,532,383,4.8777331081,6255,3.7548687716,3143,608,10,15.080475572,3131,1.4981630824,983,660
2023-2024,4,06,MontrÃ©al,INSTITUT DE CARDIOLOGIE DE MONTRÃAL,INSTITUT DE CARDIOLOGIE DE MONTRÃAL,51248201,5842,1652,143,8.601290749,5666,1.5022845825,3656,723,118,3.9714989819,3483,1.7547582703,2186,454,31,16.344437456,2183,1.0994600957,929,25
2023-2024,4,07,Outaouais,CISSS DE L'OUTAOUAIS,CENTRE MULTISERVICES DE SANTÃ ET DE SERVICES SOCIAUX DE MANSFIELD-ET-PONTEFRACT,51245058,2682,285,69,4.1969024981,2501,1.6683135635,2611,275,67,4.0808114175,2430,1.6715723594,71,1,0,8.4661111111,71,1.5567801252,10,2
2023-2024,4,07,Outaouais,CISSS DE L'OUTAOUAIS,CLSC ET CENTRE D'HÃBERGEMENT DE LA PETITE-NATION,51219491,3068,423,99,2.8683115131,2544,1.3435160072,2794,343,87,2.6829569315,2270,1.4282760646,274,1,0,4.7583870641,274,0.6413067721,80,12
2023-2024,4,07,Outaouais,CISSS DE L'OUTAOUAIS,HÃPITAL DE GATINEAU,51221703,11578,1506,1300,12.318239885,7177,4.7664737278,7563,584,392,5.9371618405,3283,5.3564212103,4015,1358,599,24.338188391,3894,4.2690937625,922,908
2023-2024,4,07,Outaouais,CISSS DE L'OUTAOUAIS,HÃPITAL DE HULL,51221711,10039,1829,313,14.3514118,6530,4.0057770972,6697,665,194,6.4953612729,3264,4.7172387323,3342,1211,697,30.094071996,3266,3.2947511397,1164,119
2023-2024,4,07,Outaouais,CISSS DE L'OUTAOUAIS,HÃPITAL DE MANIWAKI,51221893,3887,461,205,7.0055351885,3393,2.3341302355,2757,216,103,3.3957574658,2289,2.428270351,1130,200,92,15.812753933,1104,2.1389429851,245,102
2023-2024,4,07,Outaouais,CISSS DE L'OUTAOUAIS,HÃPITAL ET CHSLD DE PAPINEAU,51228823,6564,803,338,10.04710864,4834,3.5649111617,4877,360,132,4.2175358827,3171,3.7964859491,1687,562,319,26.899999177,1663,3.1233455268,443,206
2023-2024,4,07,Outaouais,CISSS DE L'OUTAOUAIS,HÃPITAL ET CHSLD DU PONTIAC,51219459,3271,404,95,5.7346260063,2989,2.0657575927,2661,284,58,4.2552509499,2381,2.1042972141,610,85,22,12.188096539,608,1.9148318713,120,37
2023-2024,4,07,Outaouais,CISSS DE L'OUTAOUAIS,HÃPITAL ET CHSLD MÃMORIAL DE WAKEFIELD / WAKEFIELD MEMORIAL HOSPITAL,51228799,4856,401,107,5.2719309445,3987,2.7103679319,4278,271,81,3.9034048231,3413,2.8200956311,578,105,30,15.400918397,574,2.0579277971,130,26
2023-2024,4,08,Abitibi-TÃ©miscamingue,CISSS DE L'ABITIBI-TÃMISCAMINGUE,CENTRE MULTISERVICES DE SANTÃ ET DE SERVICES SOCIAUX DE LA SARRE,51247559,5089,630,250,5.6491209253,4640,2.0789776102,4176,387,184,4.1996247738,3741,2.1759614185,913,101,37,12.27901789,899,1.675399827,243,66
2023-2024,4,08,Abitibi-TÃ©miscamingue,CISSS DE L'ABITIBI-TÃMISCAMINGUE,CENTRE MULTISERVICES DE SANTÃ ET DE SERVICES SOCIAUX DE TÃMISCAMING-KIPAWA,51247476,1622,139,81,2.8591375531,1541,0.9058454106,1484,110,61,2.1987436358,1404,0.9353395062,138,10,0,9.9607648953,137,0.6035847526,29,20
2023-2024,4,08,Abitibi-TÃ©miscamingue,CISSS DE L'ABITIBI-TÃMISCAMINGUE,CENTRE MULTISERVICES DE SANTÃ ET DE SERVICES SOCIAUX DE VILLE-MARIE,51247542,3218,463,167,4.8188146537,2811,2.6446591763,2779,333,128,4.0737673424,2378,2.6951873657,439,12,1,9.5351847634,433,2.3671625609,130,39
2023-2024,4,08,Abitibi-TÃ©miscamingue,CISSS DE L'ABITIBI-TÃMISCAMINGUE,HÃPITAL D'AMOS,51228906,6794,696,274,4.4279962303,5977,1.6509444073,5136,293,200,2.8842026328,4339,1.8551228522,1658,103,11,9.2102181343,1638,1.1100834351,403,74
2023-2024,4,08,Abitibi-TÃ©miscamingue,CISSS DE L'ABITIBI-TÃMISCAMINGUE,HÃPITAL DE ROUYN-NORANDA,51228922,7583,984,409,6.5617290504,5987,3.5716169293,5989,503,251,5.5952510158,4414,4.0809303731,1594,116,2,10.192994389,1573,2.1424309529,481,158
2023-2024,4,08,Abitibi-TÃ©miscamingue,CISSS DE L'ABITIBI-TÃMISCAMINGUE,HÃPITAL DE VAL-D'OR,51225589,7895,835,542,8.282162339,6357,3.858730577,6361,472,387,6.508286433,4827,4.434133117,1534,332,44,15.637849848,1530,2.0433919753,363,155
2023-2024,4,09,CÃ´te-Nord,CISSS DE LA CÃTE-NORD,CENTRE MULTISERVICES DE SANTÃ ET DE SERVICES SOCIAUX DE FERMONT,51245108,1575,6,105,4.656727866,1236,1.8590073265,1506,6,103,4.6309860558,1167,1.90636342,69,0,0,5.2185708535,69,1.0580716586,0,2
2023-2024,4,09,CÃ´te-Nord,CISSS DE LA CÃTE-NORD,CENTRE MULTISERVICES DE SANTÃ ET DE SERVICES SOCIAUX DE FORESTVILLE,51218741,3244,384,162,3.0445573024,2755,1.6300204678,2920,306,136,2.5623944064,2461,1.6992434196,324,16,1,7.3899759945,294,1.0505725624,78,26
2023-2024,4,09,CÃ´te-Nord,CISSS DE LA CÃTE-NORD,CENTRE MULTISERVICES DE SANTÃ ET DE SERVICES SOCIAUX DE LA BASSE-CÃTE-NORD,51245140,887,152,38,3.159615746,854,1.1170647931,711,109,33,2.9076246288,680,1.1470265523,176,0,0,4.1776025884,174,0.9999728608,43,5
2023-2024,4,09,CÃ´te-Nord,CISSS DE LA CÃTE-NORD,CENTRE MULTISERVICES DE SANTÃ ET DE SERVICES SOCIAUX DE LA MINGANIE,51245116,4216,466,95,2.7272197844,2096,2.1458268395,3018,311,39,1.3974767138,938,2.1807285004,1198,35,0,6.077106752,1158,2.1175558914,155,56
2023-2024,4,09,CÃ´te-Nord,CISSS DE LA CÃTE-NORD,CENTRE MULTISERVICES DE SANTÃ ET DE SERVICES SOCIAUX DE PORT-CARTIER,51245132,3866,350,229,4.9068586538,3359,2.4282829711,3510,263,211,3.7634969136,3005,2.5596681457,356,75,19,16.179891542,354,1.3129935656,87,18
2023-2024,4,09,CÃ´te-Nord,CISSS DE LA CÃTE-NORD,CENTRE MULTISERVICES DE SANTÃ ET DE SERVICES SOCIAUX DES ESCOUMINS,51218733,2543,376,92,3.6280174335,2301,1.3762168622,2251,265,72,2.7894472827,2012,1.4229260548,292,21,5,10.092474315,289,1.0510303729,111,20
2023-2024,4,09,CÃ´te-Nord,CISSS DE LA CÃTE-NORD,CLSC ET HÃPITAL LE ROYER,51228765,6538,999,406,8.4960230788,5730,3.2230796975,4854,472,221,4.9956052282,4050,3.6762145405,1684,453,151,18.585707311,1680,2.1307010582,527,185
2023-2024,4,09,CÃ´te-Nord,CISSS DE LA CÃTE-NORD,HÃPITAL ET CLSC DE SEPT-ÃLES,51232023,6250,692,435,9.4430294222,4932,3.6878155132,4159,272,196,4.9920206513,2900,4.1490872605,2091,469,172,18.296087996,2032,3.0295044565,420,239
2023-2024,4,11,GaspÃ©sie-Ãles-de-la-Madeleine,CISSS DE LA GASPÃSIE,CENTRE MULTISERVICES DE SANTÃ ET DE SERVICES SOCIAUX DE GRANDE-VALLÃE,51247732,1843,302,49,2.0362218906,1437,1.0206089074,1684,245,40,1.5979638427,1288,1.0398546411,159,11,1,6.6778983229,149,0.8542431022,57,9
2023-2024,4,11,GaspÃ©sie-Ãles-de-la-Madeleine,CISSS DE LA GASPÃSIE,CLSC ET CENTRE DE SERVICES AMBULATOIRES DE MURDOCHVILLE,51221307,602,74,36,2.302441399,588,1.0521442744,596,73,35,2.3021858688,583,1.0592886411,6,0,0,2.3278240741,5,0.2191111111,1,1
2023-2024,4,11,GaspÃ©sie-Ãles-de-la-Madeleine,CISSS DE LA GASPÃSIE,CLSC ET CENTRE DE SERVICES AMBULATOIRES DE PASPÃBIAC,51220978,3887,670,151,4.7934608953,3602,2.1077512493,2943,396,121,3.9152859894,2687,2.2266797957,944,48,10,7.5312455862,915,1.7585042502,274,30
2023-2024,4,11,GaspÃ©sie-Ãles-de-la-Madeleine,CISSS DE LA GASPÃSIE,HÃPITAL DE CHANDLER,51227775,4703,800,184,6.00308556,4177,2.0368043253,3951,528,131,3.7507817993,3428,2.2061479807,752,205,42,17.836665559,749,1.2617575286,272,53
2023-2024,4,11,GaspÃ©sie-Ãles-de-la-Madeleine,CISSS DE LA GASPÃSIE,HÃPITAL DE GASPÃ,51220903,4008,690,159,5.3451585717,3480,1.5660275383,3174,401,90,3.4725294931,2652,1.7839076378,834,106,11,12.471926792,828,0.8681796833,289,69
2023-2024,4,11,GaspÃ©sie-Ãles-de-la-Madeleine,CISSS DE LA GASPÃSIE,HÃPITAL ET CLSC DE SAINTE-ANNE-DES-MONTS,51247799,3997,654,200,5.2817960693,3588,2.0034209711,3129,366,147,3.1414419765,2730,2.1301257631,868,133,31,12.997427355,858,1.6002693603,288,53
2023-2024,4,11,GaspÃ©sie-Ãles-de-la-Madeleine,CISSS DE LA GASPÃSIE,HÃPITAL ET GROUPE DE MÃDECINE DE FAMILLE UNIVERSITAIRE DE MARIA,51227908,5015,886,272,7.8934423396,4621,2.0896567001,3727,429,136,3.9811447247,3337,2.3562568674,1288,383,124,19.214197938,1284,1.3967869505,457,136
2023-2024,4,11,GaspÃ©sie-Ãles-de-la-Madeleine,CISSS DES ÃLES,HÃPITAL DE L'ARCHIPEL,51227783,4809,655,139,3.8906990943,4395,1.2422762609,3924,426,87,2.7502320478,3516,1.3258899791,885,46,0,8.9474139987,879,0.9078213879,229,52
2023-2024,4,12,ChaudiÃ¨re-Appalaches,CISSS DE CHAUDIÃRE-APPALACHES,CHSLD ET HÃPITAL PAUL-GILBERT,51245199,12827,976,180,2.4515841801,10150,1.8654330323,12201,912,172,2.393432756,9524,1.9383464289,626,0,0,3.5849795882,626,0.7561244231,64,8
2023-2024,4,12,ChaudiÃ¨re-Appalaches,CISSS DE CHAUDIÃRE-APPALACHES,HÃPITAL DE MONTMAGNY,51245223,9493,1533,282,4.1444520524,8727,1.3741536165,7430,810,154,2.509886384,6664,1.5919457783,2063,110,5,10.031423897,2063,0.6706310928,723,128
2023-2024,4,12,ChaudiÃ¨re-Appalaches,CISSS DE CHAUDIÃRE-APPALACHES,HÃPITAL DE SAINT-GEORGES,51228971,13051,2494,693,6.3869593858,10779,2.2902901475,9398,1051,331,3.7557593519,7140,2.8233356676,3653,554,23,13.15619506,3639,1.2444135294,1443,362
2023-2024,4,12,ChaudiÃ¨re-Appalaches,CISSS DE CHAUDIÃRE-APPALACHES,HÃPITAL DE THETFORD,51245231,11156,1789,341,5.4011443518,10370,1.4721111647,8867,1003,185,3.815359385,8083,1.6615004055,2289,231,5,11.544069341,2287,0.8027481417,786,156
2023-2024,4,12,ChaudiÃ¨re-Appalaches,CISSS DE CHAUDIÃRE-APPALACHES,HÃTEL-DIEU DE LÃVIS,51227569,22268,4261,1508,7.4394155415,20135,1.4456617416,15301,1659,726,3.4662128474,13168,1.8677845914,6967,1599,282,16.165405842,6967,0.6478271375,2602,782
2023-2024,4,13,Laval,CISSS DE LAVAL,HÃPITAL DE LA CITÃ-DE-LA-SANTÃ,51228757,27068,5273,1731,9.1599121862,20941,2.7609818591,17345,1689,410,5.1288289132,11239,3.5173074166,9723,1886,196,16.351019804,9702,1.8848384926,3584,1321
2023-2024,4,14,LanaudiÃ¨re,CISSS DE LANAUDIÃRE,HÃPITAL DE LANAUDIÃRE ET CENTRE D'HÃBERGEMENT PARPHILIA-FERLAND,51244945,20953,3679,1437,9.6234006533,16995,2.5542788892,13527,1123,999,5.592965345,9614,3.4342540392,7426,1920,354,16.965132193,7381,1.4080817489,2556,438
2023-2024,4,14,LanaudiÃ¨re,CISSS DE LANAUDIÃRE,HÃPITAL PIERRE-LE GARDEUR,51228062,21977,4029,1251,10.817444336,13741,5.7977880876,14738,1432,434,6.6677157311,6546,7.3852114947,7239,2355,163,19.265945534,7195,4.3535526986,2597,817
2023-2024,4,15,Laurentides,CISSS DES LAURENTIDES,CENTRE MULTISERVICES DE SANTÃ ET DE SERVICES SOCIAUX D'ARGENTEUIL,51245306,5665,782,169,8.9030228008,4560,3.4756601486,4690,457,107,5.5891159086,3590,3.9389580625,975,373,151,24.843764672,970,1.7609802405,325,62
2023-2024,4,15,Laurentides,CISSS DES LAURENTIDES,CENTRE MULTISERVICES DE SANTÃ ET DE SERVICES SOCIAUX DE RIVIÃRE-ROUGE,51217628,4143,502,257,6.4449175316,3606,2.8773314537,3238,287,141,4.1719097008,2727,3.0335808581,905,160,43,14.577513505,879,2.3925850082,215,116
2023-2024,4,15,Laurentides,CISSS DES LAURENTIDES,CENTRE MULTISERVICES DE SANTÃ ET DE SERVICES SOCIAUX DE SAINTE-AGATHE,51246874,8995,1737,558,10.818772065,7359,3.6895310353,5785,669,151,6.1649414674,4183,4.6264918851,3210,941,148,19.20581568,3176,2.4554922334,1068,407
2023-2024,4,15,Laurentides,CISSS DES LAURENTIDES,HÃPITAL DE MONT-LAURIER,51217610,5335,804,286,10.444919296,4216,3.9371788689,3967,408,135,6.8090196202,2867,4.3481184358,1368,407,128,20.988496792,1349,3.0638180545,396,151
2023-2024,4,15,Laurentides,CISSS DES LAURENTIDES,HÃPITAL DE SAINT-EUSTACHE,51228864,14812,3056,899,12.255490931,10462,3.9519833153,8920,862,216,7.4125277466,4609,5.9652060582,5892,1844,364,19.587336077,5853,2.3666520967,2194,683
2023-2024,4,15,Laurentides,CISSS DES LAURENTIDES,HÃPITAL DE SAINT-JÃRÃME,51228880,16836,3026,1651,13.48920605,12024,4.4301371562,9678,993,403,6.5655840853,4920,6.1809144083,7158,2379,884,22.850314372,7104,3.2176056134,2033,1248
2023-2024,4,16,MontÃ©rÃ©gie,CISSS DE LA MONTÃRÃGIE-CENTRE,HÃPITAL CHARLES-LE MOYNE,51233799,22227,4107,1733,9.6168734097,12453,5.2432584295,15348,1610,677,5.9123856167,5582,6.2832109658,6879,1865,105,17.88209781,6871,4.3984010495,2497,1056
2023-2024,4,16,MontÃ©rÃ©gie,CISSS DE LA MONTÃRÃGIE-CENTRE,HÃPITAL DU HAUT-RICHELIEU,51229045,18064,2939,1050,9.7296006944,14400,2.9899243827,12318,974,328,5.2141253315,8712,3.7152082696,5746,1642,679,19.409660827,5688,1.8790465307,1965,722
2023-2024,4,16,MontÃ©rÃ©gie,CISSS DE LA MONTÃRÃGIE-EST,HÃPITAL HONORÃ-MERCIER,51229193,13317,2626,703,9.6663346975,10278,4.0175901602,8072,979,334,6.1793707328,5081,5.4075786153,5245,1153,215,15.032735674,5197,2.6586270391,1647,369
2023-2024,4,16,MontÃ©rÃ©gie,CISSS DE LA MONTÃRÃGIE-EST,HÃPITAL PIERRE-BOUCHER,51229011,17476,3697,1035,12.278799179,12441,4.9382026498,8654,1212,339,6.2887698046,3732,6.4636254019,8822,2215,719,18.154758621,8709,4.2845251081,2485,696
2023-2024,4,16,MontÃ©rÃ©gie,CISSS DE LA MONTÃRÃGIE-EST,HÃTEL-DIEU DE SOREL,51229102,10825,1743,539,7.3540699256,9400,2.2658303783,7418,718,199,3.8821904676,6014,2.5641978901,3407,739,71,14.913330806,3386,1.7358887904,1025,340
2023-2024,4,16,MontÃ©rÃ©gie,CISSS DE LA MONTÃRÃGIE-OUEST,HÃPITAL ANNA-LABERGE,51229151,11207,2340,704,16.9937544,8637,2.5413524501,6935,703,166,9.8511591765,4365,4.0050750923,4272,1954,802,28.588767946,4272,1.0457650593,1637,538
2023-2024,4,16,MontÃ©rÃ©gie,CISSS DE LA MONTÃRÃGIE-OUEST,HÃPITAL BARRIE MEMORIAL / BARRIE MEMORIAL HOSPITAL,51228005,6451,731,109,5.9693656453,5341,3.1410069379,5413,458,86,4.1690203112,4318,3.0484206937,1038,229,35,15.357871708,1023,3.5318059629,273,23
2023-2024,4,16,MontÃ©rÃ©gie,CISSS DE LA MONTÃRÃGIE-OUEST,HÃPITAL DU SUROÃT,51229136,11488,2403,859,13.293084499,9297,2.3102093268,7498,803,477,4.6063552132,5317,3.0814603578,3990,1515,802,29.617168755,3980,1.2798722083,1600,382
2024-2025,4,01,Bas-Saint-Laurent,CISSS DU BAS-SAINT-LAURENT,CENTRE HOSPITALIER RÃGIONAL DU GRAND-PORTAGE,51218352,7390,1465,359,5.000561908,6048,2.3382173629,5378,624,214,3.4128732284,4048,2.6527313214,2012,35,0,9.2443937762,2000,1.7016411111,841,145
2024-2025,4,01,Bas-Saint-Laurent,CISSS DU BAS-SAINT-LAURENT,CENTRE MULTISERVICES DE SANTÃ ET DE SERVICES SOCIAUX DE TROIS-PISTOLES,51236156,4091,566,98,2.9423723485,3726,1.4294952884,3584,388,74,2.3995494637,3228,1.5060027709,507,4,1,6.7796055227,498,0.9335793173,178,24
2024-2025,4,01,Bas-Saint-Laurent,CISSS DU BAS-SAINT-LAURENT,CLSC DE POHÃNÃGAMOOK,51219418,4375,504,130,1.7710665397,4051,1.0227853891,4150,440,123,1.4945680054,3827,1.0276817496,225,5,0,6.8709283951,224,0.9391319444,64,7
2024-2025,4,01,Bas-Saint-Laurent,CISSS DU BAS-SAINT-LAURENT,HÃPITAL D'AMQUI,51226892,5143,771,165,4.5081710848,4540,1.7446340553,3549,341,105,3.4979265677,2993,2.0482051639,1594,63,4,6.7574545169,1547,1.1573112835,430,60
2024-2025,4,01,Bas-Saint-Laurent,CISSS DU BAS-SAINT-LAURENT,HÃPITAL DE MATANE,51218980,5911,1099,234,5.7433888795,5238,2.7527397013,4240,498,137,4.5251688941,3604,3.1182746023,1671,127,9,8.8345036239,1634,1.946504828,601,97
2024-2025,4,01,Bas-Saint-Laurent,CISSS DU BAS-SAINT-LAURENT,HÃPITAL DE NOTRE-DAME-DU-LAC,51221877,4700,858,116,3.5102217494,4215,1.547198102,3774,481,64,2.4818432403,3292,1.7308869144,926,22,0,7.701474982,923,0.8920479716,377,52
2024-2025,4,01,Bas-Saint-Laurent,CISSS DU BAS-SAINT-LAURENT,HÃPITAL NOTRE-DAME-DE-FATIMA,51221141,5969,994,151,3.9740855997,5425,1.8531987199,4766,545,76,3.0432135031,4243,2.016737175,1203,10,0,7.6619795419,1182,1.2661482422,449,75
2024-2025,4,01,Bas-Saint-Laurent,CISSS DU BAS-SAINT-LAURENT,HÃPITAL RÃGIONAL DE RIMOUSKI,51227882,10433,1942,622,6.3269145979,8292,2.5045404875,7387,861,359,4.2943285126,5275,3.0056628752,3046,318,37,11.256236138,3017,1.6283652819,1081,263
2024-2025,4,02,Saguenay-Lac-Saint-Jean,CIUSSS DU SAGUENAY - LAC-SAINT-JEAN,HÃPITAL D'ALMA,51219400,12336,1975,440,4.9982356067,9725,3.1184363325,9592,1101,212,4.0667701383,7044,3.4116292826,2744,38,0,8.254291282,2681,2.3481076713,874,228
2024-2025,4,02,Saguenay-Lac-Saint-Jean,CIUSSS DU SAGUENAY - LAC-SAINT-JEAN,HÃPITAL DE CHICOUTIMI,51218394,17763,2987,1096,7.8619846497,15407,2.9144100265,10115,961,265,4.4404952765,7829,3.8631507146,7648,985,64,12.387136978,7578,1.9342449635,2026,831
2024-2025,4,02,Saguenay-Lac-Saint-Jean,CIUSSS DU SAGUENAY - LAC-SAINT-JEAN,HÃPITAL DE DOLBEAU-MISTASSINI,51219384,7443,1261,251,4.4703054697,6647,2.1638141267,6276,837,152,3.3448642979,5487,2.3457031772,1167,103,15,10.522806579,1160,1.3034475575,424,99
2024-2025,4,02,Saguenay-Lac-Saint-Jean,CIUSSS DU SAGUENAY - LAC-SAINT-JEAN,HÃPITAL DE LA BAIE,51221364,6297,872,205,5.5725962098,5713,2.8307481961,4761,376,119,4.2391799108,4188,3.1329052584,1536,46,1,9.7056658709,1525,2.0009555556,496,86
2024-2025,4,02,Saguenay-Lac-Saint-Jean,CIUSSS DU SAGUENAY - LAC-SAINT-JEAN,HÃPITAL ET CENTRE D'HÃBERGEMENT DE ROBERVAL,51228203,8421,1245,457,5.5349129491,7527,2.4784305759,5863,554,142,3.6463426952,5030,2.7240685332,2558,188,6,9.8635632221,2497,1.9836132248,691,315
2024-2025,4,02,Saguenay-Lac-Saint-Jean,CIUSSS DU SAGUENAY - LAC-SAINT-JEAN,HÃPITAL ET CENTRE DE RÃADAPTATION DE JONQUIÃRE,51224541,9072,1691,475,7.1756618043,7109,3.7119707022,5721,591,194,4.5992020626,3877,4.0746131029,3351,262,4,11.574326735,3232,3.2769569066,1100,281
2024-2025,4,03,Capitale-Nationale,CHU DE QUÃBEC - UNIVERSITÃ LAVAL,CENTRE HOSPITALIER DE L'UNIVERSITÃ LAVAL,51217594,24477,2247,2401,8.1352916343,19967,2.3420993946,13870,443,779,4.9639550789,9418,3.4268967816,10607,1210,253,12.282217063,10549,1.3736074246,1804,1622
2024-2025,4,03,Capitale-Nationale,CHU DE QUÃBEC - UNIVERSITÃ LAVAL,HÃPITAL DE L'ENFANT-JÃSUS,51233914,21540,3693,2637,9.6943726787,19351,1.7247551806,12000,1197,695,4.0723975694,9880,2.2022452767,9540,2185,416,16.766039483,9471,1.2266449337,2496,1942
2024-2025,4,03,Capitale-Nationale,CHU DE QUÃBEC - UNIVERSITÃ LAVAL,HÃPITAL DU SAINT-SACREMENT,51217529,12160,2870,379,7.4060312728,9976,2.105971554,8546,1164,128,3.7615148087,6373,2.5400336925,3614,870,95,16.024193338,3603,1.3382008049,1706,251
2024-2025,4,03,Capitale-Nationale,CHU DE QUÃBEC - UNIVERSITÃ LAVAL,HÃPITAL SAINT-FRANÃOIS D'ASSISE,51217602,13508,3595,433,10.825322443,11086,2.4265272015,7812,1041,213,5.0137886158,5417,3.4444416241,5696,1765,217,18.795775788,5669,1.4538614002,2554,220
2024-2025,4,03,Capitale-Nationale,CHU DE QUÃBEC - UNIVERSITÃ LAVAL,L'HÃTEL-DIEU DE QUÃBEC,51217586,7622,1682,374,7.0088659655,6757,1.8195749675,4122,388,147,3.4677725214,3300,2.1379191919,3500,244,8,11.179262302,3457,1.5156883778,1294,227
2024-2025,4,03,Capitale-Nationale,CIUSSS DE LA CAPITALE-NATIONALE,CENTRE MULTISERVICES DE SANTÃ ET DE SERVICES SOCIAUX CHAUVEAU,51225001,13927,1013,227,2.8315267107,9768,1.6802409227,12466,844,191,2.6548429952,8342,1.7835372546,1461,0,0,4.3390826299,1426,1.0759646252,169,36
2024-2025,4,03,Capitale-Nationale,CIUSSS DE LA CAPITALE-NATIONALE,CENTRE MULTISERVICES DE SANTÃ ET DE SERVICES SOCIAUX DE BAIE-SAINT-PAUL,51244804,4281,763,132,5.4293005918,3287,2.328118345,3432,462,64,3.4109384713,2443,2.6290417065,849,112,15,13.588333333,844,1.4570807004,301,68
2024-2025,4,03,Capitale-Nationale,CIUSSS DE LA CAPITALE-NATIONALE,CENTRE MULTISERVICES DE SANTÃ ET DE SERVICES SOCIAUX DE SAINT-MARC-DES-CARRIÃRES,51247344,6225,821,127,2.7965800535,5117,1.4910591058,5084,478,73,2.1977804004,4005,1.6987490637,1141,14,1,5.4646759665,1112,0.7430390687,343,54
2024-2025,4,03,Capitale-Nationale,CIUSSS DE LA CAPITALE-NATIONALE,CENTRE MULTISERVICES DE SANTÃ ET DE SERVICES SOCIAUX DE SAINT-RAYMOND,51247302,6880,937,151,4.289606468,5559,2.0533670125,5570,529,82,3.293414223,4273,2.3307932236,1310,58,11,8.5253246395,1286,1.131561258,408,69
2024-2025,4,03,Capitale-Nationale,CIUSSS DE LA CAPITALE-NATIONALE,CENTRE MULTISERVICES DE SANTÃ ET DE SERVICES SOCIAUX DE SAINTE-ANNE-DE-BEAUPRÃ,51225357,5412,676,74,4.2132987908,3997,2.1655791149,4568,408,45,3.3211268,3172,2.3904171045,844,42,7,9.0420211295,825,1.3011111111,268,29
2024-2025,4,03,Capitale-Nationale,CIUSSS DE LA CAPITALE-NATIONALE,HÃPITAL ET CLSC DE LA MALBAIE,51228690,4965,929,136,5.103296632,4017,2.0155518906,4108,607,77,3.4708110868,3162,2.2966033277,857,106,14,12.928559899,855,0.9761546459,322,59
2024-2025,4,03,Capitale-Nationale,INSTITUT UNIVERSITAIRE DE CARDIOLOGIE ET DE PNEUMOLOGIE DE QUÃBEC - UNIVERSITÃ LAVAL,INSTITUT UNIVERSITAIRE DE CARDIOLOGIE ET DE PNEUMOLOGIE DE QUÃBEC,51232130,9917,3323,181,7.9589498392,9315,2.0651957715,5140,1159,93,4.1577931799,4555,2.6368627272,4777,489,0,12.048953027,4760,1.5181489262,2164,88
2024-2025,4,04,Mauricie et Centre-du-QuÃ©bec,CIUSSS DE LA MAURICIE-ET-DU-CENTRE-DU-QUÃBEC,CENTRE MULTISERVICES DE SANTÃ ET DE SERVICES SOCIAUX AVELLIN-DALCOURT,51233583,7239,1083,182,4.9235495234,5793,2.9416530007,6122,624,100,4.1542356347,4686,3.3077447005,1117,46,5,9.1399681687,1107,1.3919640169,459,82
2024-2025,4,04,Mauricie et Centre-du-QuÃ©bec,CIUSSS DE LA MAURICIE-ET-DU-CENTRE-DU-QUÃBEC,CENTRE MULTISERVICES DE SANTÃ ET DE SERVICES SOCIAUX CHRIST-ROI,51246338,7535,887,207,5.0225986139,6154,3.2549719243,6092,418,125,4.1696612588,4759,3.5431763793,1443,63,7,8.623495611,1395,2.2717712067,469,82
2024-2025,4,04,Mauricie et Centre-du-QuÃ©bec,CIUSSS DE LA MAURICIE-ET-DU-CENTRE-DU-QUÃBEC,CENTRE MULTISERVICES DE SANTÃ ET DE SERVICES SOCIAUX DE FORTIERVILLE,51219160,4653,521,81,2.7661974353,3744,2.0651308761,4296,467,75,2.6650779795,3388,2.1499426079,357,0,0,3.9830298786,356,1.2579900125,54,6
2024-2025,4,04,Mauricie et Centre-du-QuÃ©bec,CIUSSS DE LA MAURICIE-ET-DU-CENTRE-DU-QUÃBEC,CENTRE MULTISERVICES DE SANTÃ ET DE SERVICES SOCIAUX DU HAUT-SAINT-MAURICE,51219731,4246,635,239,6.1549621866,3687,2.8156507097,3196,378,112,4.3518808233,2656,3.0715947122,1050,86,3,11.643198413,1031,2.1563032116,257,127
2024-2025,4,04,Mauricie et Centre-du-QuÃ©bec,CIUSSS DE LA MAURICIE-ET-DU-CENTRE-DU-QUÃBEC,HÃPITAL DU CENTRE-DE-LA-MAURICIE,51220051,11734,2250,783,6.9934622559,9491,2.995243886,7268,669,166,4.8964979667,5051,4.3140530478,4466,277,11,10.406076778,4440,1.4949499499,1581,617
2024-2025,4,04,Mauricie et Centre-du-QuÃ©bec,CIUSSS DE LA MAURICIE-ET-DU-CENTRE-DU-QUÃBEC,HÃPITAL SAINTE-CROIX,51228781,13948,2193,843,8.0241410557,10181,3.8399525532,8003,649,230,6.166494509,4435,5.2167628085,5945,373,0,10.524855154,5746,2.7772735623,1544,613
2024-2025,4,04,Mauricie et Centre-du-QuÃ©bec,CIUSSS DE LA MAURICIE-ET-DU-CENTRE-DU-QUÃBEC,HÃTEL-DIEU D'ARTHABASKA,51228039,12596,2417,678,6.0803129741,10319,2.6168716553,7369,850,123,4.515615906,5218,3.4603099314,5227,184,1,8.2862155368,5101,1.7540877061,1567,555
2024-2025,4,04,Mauricie et Centre-du-QuÃ©bec,CIUSSS DE LA MAURICIE-ET-DU-CENTRE-DU-QUÃBEC,PAVILLON SAINTE-MARIE,51220168,20140,4775,1126,9.7284410515,15674,3.3551325266,10946,1203,285,5.3985189922,6563,4.8400678467,9194,1711,103,14.883468989,9111,2.2854771095,3572,841
2024-2025,4,05,Estrie,CIUSSS DE L'ESTRIE - CENTRE HOSPITALIER UNIVERSITAIRE DE SHERBROOKE,CENTRE DE SANTÃ ET DE SERVICES SOCIAUX DU GRANIT,51223832,5229,878,133,5.0033499076,4494,2.9550715769,4232,542,72,4.0963111741,3506,3.1906929391,997,32,0,8.8534882425,988,2.1189496176,336,61
2024-2025,4,05,Estrie,CIUSSS DE L'ESTRIE - CENTRE HOSPITALIER UNIVERSITAIRE DE SHERBROOKE,CENTRE MULTISERVICES DE SANTÃ ET DE SERVICES SOCIAUX DE LA MRC DE COATICOOK,51247617,6981,563,201,3.0522125531,5662,2.2550860513,5856,386,164,2.9320582878,4567,2.4391343089,1125,0,0,3.6776555556,1095,1.4874619482,177,37
2024-2025,4,05,Estrie,CIUSSS DE L'ESTRIE - CENTRE HOSPITALIER UNIVERSITAIRE DE SHERBROOKE,CENTRE MULTISERVICES DE SANTÃ ET DE SERVICES SOCIAUX DE MEMPHRÃMAGOG,51219046,8228,1685,278,6.8915873305,6296,4.120631265,6026,810,126,5.2601410093,4165,4.776106776,2202,255,29,11.356208371,2131,2.8395165285,875,152
2024-2025,4,05,Estrie,CIUSSS DE L'ESTRIE - CENTRE HOSPITALIER UNIVERSITAIRE DE SHERBROOKE,CENTRE MULTISERVICES DE SANTÃ ET DE SERVICES SOCIAUX DES SOURCES,51247583,6050,806,192,5.1842426538,5001,3.5941370059,5270,556,141,4.5905718954,4238,3.8513613602,780,43,4,9.1953258547,763,2.16541248,250,51
2024-2025,4,05,Estrie,CIUSSS DE L'ESTRIE - CENTRE HOSPITALIER UNIVERSITAIRE DE SHERBROOKE,CHUS - HÃPITAL FLEURIMONT,51216687,15085,2206,346,8.7137377085,12839,3.0049640419,7734,441,116,6.7632014482,5491,5.3263127542,7351,678,12,10.765900331,7348,1.270270822,1765,230
2024-2025,4,05,Estrie,CIUSSS DE L'ESTRIE - CENTRE HOSPITALIER UNIVERSITAIRE DE SHERBROOKE,CHUS - HÃTEL-DIEU DE SHERBROOKE,51216695,15394,3291,1813,10.893390282,13045,3.4471176696,7774,877,450,6.7659806192,5439,5.3736900165,7620,1162,276,15.104214786,7606,2.0694386011,2414,1363
2024-2025,4,05,Estrie,CIUSSS DE L'ESTRIE - CENTRE HOSPITALIER UNIVERSITAIRE DE SHERBROOKE,HÃPITAL BROME-MISSISQUOI-PERKINS,51229185,9846,1619,332,9.3925248832,7856,4.545265473,6767,510,123,6.0275185541,4824,5.2652535931,3079,814,50,16.78810716,3032,3.399743477,1109,209
2024-2025,4,05,Estrie,CIUSSS DE L'ESTRIE - CENTRE HOSPITALIER UNIVERSITAIRE DE SHERBROOKE,HÃPITAL DE GRANBY,51228120,12446,2078,715,12.144837922,9345,5.6623804173,8658,804,256,8.3587236596,5580,7.254472272,3788,1334,182,20.798527807,3765,3.3027861148,1274,459
2024-2025,4,06,MontrÃ©al,CENTRE HOSPITALIER DE L'UNIVERSITÃ DE MONTRÃAL,CENTRE HOSPITALIER DE L'UNIVERSITÃ DE MONTRÃAL,51236297,25648,3741,2069,12.019635373,18758,3.0085917712,15290,1050,682,7.2527458579,8477,4.8920909192,10358,3216,363,19.056296958,10281,1.4555889235,2691,1387
2024-2025,4,06,MontrÃ©al,CENTRE HOSPITALIER UNIVERSITAIRE SAINTE-JUSTINE,CHU SAINTE-JUSTINE,51222800,25213,1,645,4.4468839377,22490,1.4555345092,16409,0,238,3.5722465991,13861,1.8111545183,8804,70,4,6.0770434209,8629,0.8842923089,1,407
2024-2025,4,06,MontrÃ©al,CENTRE UNIVERSITAIRE DE SANTÃ MCGILL,HÃPITAL DE LACHINE,51228310,6594,976,202,9.6226285259,5529,3.2319580093,5054,451,88,4.7949069494,4001,3.4482521731,1540,522,246,25.466332973,1528,2.6656013671,525,114
2024-2025,4,06,MontrÃ©al,CENTRE UNIVERSITAIRE DE SANTÃ MCGILL,HÃPITAL GÃNÃRAL DE MONTRÃAL,51248219,11202,1628,1438,15.800895624,9707,1.6969797569,4536,348,278,5.2632149593,3108,2.4543689225,6666,1847,871,22.971450603,6599,1.3402642656,1280,1160
2024-2025,4,06,MontrÃ©al,CENTRE UNIVERSITAIRE DE SANTÃ MCGILL,HÃPITAL ROYAL VICTORIA,51223295,15497,2571,350,17.261378242,11667,4.5750255945,9312,634,145,9.1237862734,5602,6.4429864334,6185,2663,1224,29.513157774,6065,2.8496642393,1937,205
2024-2025,4,06,MontrÃ©al,CENTRE UNIVERSITAIRE DE SANTÃ MCGILL,L'HÃPITAL DE MONTRÃAL POUR ENFANTS,51223279,23622,6,714,5.1158741498,22155,1.4347440382,18371,1,205,4.2300174944,16918,1.6130914148,5251,124,8,8.2151071754,5237,0.8585972143,5,509
2024-2025,4,06,MontrÃ©al,CIUSSS DE L'EST-DE-L'ÃLE-DE-MONTRÃAL,HÃPITAL MAISONNEUVE-ROSEMONT,12934659,22972,4070,1372,11.295590248,16243,3.4514696929,13907,1092,321,5.1774206635,7259,4.9157176532,9065,2982,784,20.681733039,8984,2.2683690759,2978,1051
2024-2025,4,06,MontrÃ©al,CIUSSS DE L'EST-DE-L'ÃLE-DE-MONTRÃAL,HÃPITAL SANTA CABRINI,51235919,12115,3029,440,13.224760169,9303,3.3058928124,6923,743,163,5.7523799493,4138,4.8783141346,5192,1895,626,23.188413532,5165,2.0461291277,2286,277
2024-2025,4,06,MontrÃ©al,CIUSSS DE L'EST-DE-L'ÃLE-DE-MONTRÃAL,INSTITUT UNIVERSITAIRE EN SANTÃ MENTALE DE MONTRÃAL,51235307,1639,75,1635,12.078192156,1588,1.3040757067,796,27,793,3.3465487158,745,1.3647222222,843,243,68,20.323017991,843,1.2504794385,48,842
2024-2025,4,06,MontrÃ©al,CIUSSS DE L'OUEST-DE-L'ÃLE-DE-MONTRÃAL,CENTRE HOSPITALIER DE ST. MARY,51248243,11630,2399,814,9.9149330754,10391,2.6708572055,7257,740,284,5.9183350941,6024,3.4107316106,4373,899,54,16.547293366,4367,1.6502473094,1659,530
2024-2025,4,06,MontrÃ©al,CIUSSS DE L'OUEST-DE-L'ÃLE-DE-MONTRÃAL,HÃPITAL DE LASALLE,51224392,9381,1436,300,9.4618755108,7642,3.5402923173,7177,624,106,5.8118089421,5451,4.2039541674,2204,719,234,21.3477774,2191,1.8891646382,812,194
2024-2025,4,06,MontrÃ©al,CIUSSS DE L'OUEST-DE-L'ÃLE-DE-MONTRÃAL,HÃPITAL DOUGLAS,51235190,2105,53,2042,13.288826867,1948,2.2073437144,1062,22,1004,4.0759533898,906,2.2975441501,1043,352,81,22.669528337,1042,2.1289160802,31,1038
2024-2025,4,06,MontrÃ©al,CIUSSS DE L'OUEST-DE-L'ÃLE-DE-MONTRÃAL,HÃPITAL GÃNÃRAL DU LAKESHORE,51228278,13032,3072,796,13.096586927,10604,2.8408409824,7812,816,107,7.0128770908,5409,3.7359239231,5220,1848,475,22.201173372,5195,1.9088864827,2256,689
2024-2025,4,06,MontrÃ©al,CIUSSS DU CENTRE-OUEST-DE-L'ÃLE-DE-MONTRÃAL,HÃPITAL GÃNÃRAL JUIF,51248250,31516,5861,1654,10.911922533,26913,2.6753141708,10739,636,158,3.8280905009,6742,3.1233143808,20777,3283,975,14.573340072,20171,2.525573582,5225,1496
2024-2025,4,06,MontrÃ©al,CIUSSS DU CENTRE-SUD-DE-L'ÃLE-DE-MONTRÃAL,HÃPITAL DE VERDUN,51218097,14518,2536,847,8.8780240238,12211,2.4718212859,9644,853,289,4.7745270519,7355,3.2307589319,4874,1257,87,16.997458738,4856,1.3223183233,1683,558
2024-2025,4,06,MontrÃ©al,CIUSSS DU CENTRE-SUD-DE-L'ÃLE-DE-MONTRÃAL,HÃPITAL NOTRE-DAME,51236313,12617,1781,1865,11.331168375,10562,2.2036559259,7666,352,755,5.9162805824,5632,3.0959674874,4951,1400,228,19.715440203,4930,1.1842849899,1429,1110
2024-2025,4,06,MontrÃ©al,CIUSSS DU NORD-DE-L'ÃLE-DE-MONTRÃAL,HÃPITAL DU SACRÃ-COEUR-DE-MONTRÃAL,12475976,22214,4248,1006,11.697952655,16995,3.3694383642,14876,1310,395,6.6050837105,9677,4.7715463355,7338,2824,720,22.022498637,7318,1.5153527072,2938,611
2024-2025,4,06,MontrÃ©al,CIUSSS DU NORD-DE-L'ÃLE-DE-MONTRÃAL,HÃPITAL EN SANTÃ MENTALE ALBERT-PRÃVOST,51848752,1120,53,1115,21.849330357,1101,0.4124364214,477,32,472,4.4499254601,458,0.5807987627,643,400,169,34.75682046,643,0.2925142561,21,643
2024-2025,4,06,MontrÃ©al,CIUSSS DU NORD-DE-L'ÃLE-DE-MONTRÃAL,HÃPITAL FLEURY,51228492,10568,1822,266,9.016239013,7809,3.5813841935,7700,705,115,5.5003459596,4952,4.4755811344,2868,871,53,18.455700837,2857,2.0314845603,1117,151
2024-2025,4,06,MontrÃ©al,CIUSSS DU NORD-DE-L'ÃLE-DE-MONTRÃAL,HÃPITAL JEAN-TALON,51228500,14249,1829,1114,7.5957574021,10194,3.4003899353,10635,582,378,5.1283662435,6597,4.4080611136,3614,699,14,14.856605485,3597,1.5522924196,1247,736
2024-2025,4,06,MontrÃ©al,INSTITUT DE CARDIOLOGIE DE MONTRÃAL,INSTITUT DE CARDIOLOGIE DE MONTRÃAL,51248201,6533,1795,144,7.5113378234,6338,1.6144786298,4277,895,127,3.6950987842,4082,1.8883624585,2256,387,24,14.746291002,2256,1.1189140071,900,17
2024-2025,4,07,Outaouais,CISSS DE L'OUTAOUAIS,CENTRE MULTISERVICES DE SANTÃ ET DE SERVICES SOCIAUX DE MANSFIELD-ET-PONTEFRACT,51245058,3214,391,81,3.4820404653,2995,1.5724271935,3127,369,80,3.3353213943,2908,1.5723090517,87,2,0,8.7554948914,87,1.5763761175,22,1
2024-2025,4,07,Outaouais,CISSS DE L'OUTAOUAIS,CLSC ET CENTRE D'HÃBERGEMENT DE LA PETITE-NATION,51219491,3542,484,132,3.350396198,3016,1.7412451186,3222,388,124,3.2328152804,2696,1.8436063716,320,0,0,4.5342890625,320,0.8788515625,96,8
2024-2025,4,07,Outaouais,CISSS DE L'OUTAOUAIS,HÃPITAL DE GATINEAU,51221703,12750,1777,1589,12.987671699,8203,5.9639958281,7735,572,401,7.1593923723,3489,6.5215002707,5015,1462,446,21.977051678,4714,5.5513668505,1205,1188
2024-2025,4,07,Outaouais,CISSS DE L'OUTAOUAIS,HÃPITAL DE HULL,51221711,11621,2348,389,13.146105016,7863,5.3618255684,7336,707,246,7.4130400688,3695,6.3680648775,4285,1521,496,22.96121924,4168,4.4697780044,1641,143
2024-2025,4,07,Outaouais,CISSS DE L'OUTAOUAIS,HÃPITAL DE MANIWAKI,51221893,4631,660,261,6.8685625855,3957,2.6284223458,3464,365,148,3.7596405889,2811,2.7444957311,1167,252,89,16.096759497,1146,2.3437083091,295,113
2024-2025,4,07,Outaouais,CISSS DE L'OUTAOUAIS,HÃPITAL ET CHSLD DE PAPINEAU,51228823,7877,1007,403,8.4475103325,5866,3.9651670171,5691,411,160,4.4533610086,3722,4.2397699116,2186,577,140,18.845819483,2144,3.4884543429,596,243
2024-2025,4,07,Outaouais,CISSS DE L'OUTAOUAIS,HÃPITAL ET CHSLD DU PONTIAC,51219459,4018,490,140,5.8920439273,3671,2.3798185478,3440,384,95,4.6502576712,3095,2.4657920481,578,75,25,13.282605729,576,1.9178602431,106,45
2024-2025,4,07,Outaouais,CISSS DE L'OUTAOUAIS,HÃPITAL ET CHSLD MÃMORIAL DE WAKEFIELD / WAKEFIELD MEMORIAL HOSPITAL,51228799,5467,481,144,5.828573461,4547,3.3420484202,4807,314,93,4.6388854795,3896,3.4985596338,660,121,14,14.493467593,651,2.4053853047,167,51
2024-2025,4,08,Abitibi-TÃ©miscamingue,CISSS DE L'ABITIBI-TÃMISCAMINGUE,CENTRE MULTISERVICES DE SANTÃ ET DE SERVICES SOCIAUX DE LA SARRE,51247559,6183,766,324,5.8375756555,5443,2.7807999061,5070,465,234,4.8587129082,4349,2.9420211543,1113,126,13,10.296546122,1094,2.1398938655,301,90
2024-2025,4,08,Abitibi-TÃ©miscamingue,CISSS DE L'ABITIBI-TÃMISCAMINGUE,CENTRE MULTISERVICES DE SANTÃ ET DE SERVICES SOCIAUX DE TÃMISCAMING-KIPAWA,51247476,1789,155,132,2.4818261288,1698,0.9376797867,1669,123,118,1.9790653086,1578,0.9675802704,120,5,0,9.4743912037,120,0.5444884259,32,14
2024-2025,4,08,Abitibi-TÃ©miscamingue,CISSS DE L'ABITIBI-TÃMISCAMINGUE,CENTRE MULTISERVICES DE SANTÃ ET DE SERVICES SOCIAUX DE VILLE-MARIE,51247542,3829,541,173,4.6852588433,3294,2.5439128382,3202,346,114,3.8705269276,2675,2.6298417445,627,12,2,8.8459790891,619,2.1725722491,195,59
2024-2025,4,08,Abitibi-TÃ©miscamingue,CISSS DE L'ABITIBI-TÃMISCAMINGUE,HÃPITAL D'AMOS,51228906,8544,900,345,4.6032735448,7727,1.9872163985,6518,407,269,3.3235586922,5724,2.2077140112,2026,120,7,8.7203423549,2003,1.3570974094,493,76
2024-2025,4,08,Abitibi-TÃ©miscamingue,CISSS DE L'ABITIBI-TÃMISCAMINGUE,HÃPITAL DE ROUYN-NORANDA,51228922,9410,1236,491,7.0517091451,7194,4.0696548435,7594,612,334,6.1961023323,5398,4.6370266251,1816,128,1,10.629615608,1796,2.3643804133,624,157
2024-2025,4,08,Abitibi-TÃ©miscamingue,CISSS DE L'ABITIBI-TÃMISCAMINGUE,HÃPITAL DE VAL-D'OR,51225589,9272,1099,638,7.5441367079,7575,4.0020244958,7661,644,462,5.860707552,5975,4.5138168759,1611,354,61,15.549568591,1600,2.0907998264,455,176
2024-2025,4,09,CÃ´te-Nord,CISSS DE LA CÃTE-NORD,CENTRE MULTISERVICES DE SANTÃ ET DE SERVICES SOCIAUX DE FERMONT,51245108,2028,17,144,5.6577503835,1786,2.1263960433,1918,14,134,5.6644476306,1677,2.1805734446,110,0,0,5.5409747475,109,1.2928593272,3,10
2024-2025,4,09,CÃ´te-Nord,CISSS DE LA CÃTE-NORD,CENTRE MULTISERVICES DE SANTÃ ET DE SERVICES SOCIAUX DE FORESTVILLE,51218741,3689,561,208,3.9974442788,2986,2.2669299323,3189,419,163,3.3935911641,2531,2.4844809913,500,23,6,7.8488194444,455,1.0567722833,142,45
2024-2025,4,09,CÃ´te-Nord,CISSS DE LA CÃTE-NORD,CENTRE MULTISERVICES DE SANTÃ ET DE SERVICES SOCIAUX DE LA BASSE-CÃTE-NORD,51245140,1233,180,43,2.7250777237,1204,0.8698232743,991,124,36,2.4752758157,962,0.8898221298,242,1,0,3.7480268595,242,0.7903236915,56,7
2024-2025,4,09,CÃ´te-Nord,CISSS DE LA CÃTE-NORD,CENTRE MULTISERVICES DE SANTÃ ET DE SERVICES SOCIAUX DE LA MINGANIE,51245116,4558,488,138,3.1195872946,2347,2.5592793401,3283,366,44,1.7148191864,1108,2.6840861913,1275,44,2,6.736727451,1239,2.4476683705,122,94
2024-2025,4,09,CÃ´te-Nord,CISSS DE LA CÃTE-NORD,CENTRE MULTISERVICES DE SANTÃ ET DE SERVICES SOCIAUX DE PORT-CARTIER,51245132,4898,461,200,5.9040757565,4115,3.1630596733,4481,357,170,4.783278658,3703,3.328563177,417,99,35,17.947940981,412,1.6755366775,104,30
2024-2025,4,09,CÃ´te-Nord,CISSS DE LA CÃTE-NORD,CENTRE MULTISERVICES DE SANTÃ ET DE SERVICES SOCIAUX DES ESCOUMINS,51218733,3491,502,128,4.0994269391,3037,1.9183352541,3081,350,111,3.4135764903,2637,1.9934366705,410,22,0,9.2533421409,400,1.4232291667,152,17
2024-2025,4,09,CÃ´te-Nord,CISSS DE LA CÃTE-NORD,CLSC ET HÃPITAL LE ROYER,51228765,7659,1138,455,9.4242484151,6597,3.9965499048,5737,510,243,5.9289534794,4681,4.6061417313,1922,511,222,19.857394641,1916,2.5072496231,628,212
2024-2025,4,09,CÃ´te-Nord,CISSS DE LA CÃTE-NORD,HÃPITAL ET CLSC DE SEPT-ÃLES,51232023,7108,890,573,8.5833081661,5405,4.5255822284,4871,367,240,5.8456443464,3241,5.0507016867,2237,342,63,14.544488526,2164,3.7391163483,523,333
2024-2025,4,11,GaspÃ©sie-Ãles-de-la-Madeleine,CISSS DE LA GASPÃSIE,CENTRE MULTISERVICES DE SANTÃ ET DE SERVICES SOCIAUX DE GRANDE-VALLÃE,51247732,2422,509,60,2.1516098954,1814,1.2054670464,2290,453,56,1.8651948083,1693,1.2409301372,132,7,3,7.1204776936,121,0.7092768595,56,4
2024-2025,4,11,GaspÃ©sie-Ãles-de-la-Madeleine,CISSS DE LA GASPÃSIE,CLSC ET CENTRE DE SERVICES AMBULATOIRES DE MURDOCHVILLE,51221307,681,103,28,3.6973776309,666,2.2857766099,669,97,28,3.6495295632,654,2.3078920319,12,1,0,6.3649074074,12,1.0804861111,6,0
2024-2025,4,11,GaspÃ©sie-Ãles-de-la-Madeleine,CISSS DE LA GASPÃSIE,CLSC ET CENTRE DE SERVICES AMBULATOIRES DE PASPÃBIAC,51220978,4577,813,163,4.0032667565,4276,1.9213557582,3292,477,121,3.1583516437,3015,2.0293769117,1285,45,5,6.1678274968,1261,1.663081549,336,42
2024-2025,4,11,GaspÃ©sie-Ãles-de-la-Madeleine,CISSS DE LA GASPÃSIE,HÃPITAL DE CHANDLER,51227775,5630,967,214,5.1850362641,4807,2.4001954904,4843,630,167,4.2660253631,4027,2.5915103606,787,41,0,10.840398136,780,1.4124711538,337,47
2024-2025,4,11,GaspÃ©sie-Ãles-de-la-Madeleine,CISSS DE LA GASPÃSIE,HÃPITAL DE GASPÃ,51220903,4657,727,184,5.3275306587,3966,1.6776027484,3644,421,103,3.6416556897,2979,1.9456676364,1013,103,3,11.392020676,987,0.8685193628,306,81
2024-2025,4,11,GaspÃ©sie-Ãles-de-la-Madeleine,CISSS DE LA GASPÃSIE,HÃPITAL ET CLSC DE SAINTE-ANNE-DES-MONTS,51247799,4737,840,187,4.7720691718,4284,2.0209173021,3770,499,118,3.0573916888,3330,2.1353871371,967,106,20,11.457006205,954,1.6213527836,341,69
2024-2025,4,11,GaspÃ©sie-Ãles-de-la-Madeleine,CISSS DE LA GASPÃSIE,HÃPITAL ET GROUPE DE MÃDECINE DE FAMILLE UNIVERSITAIRE DE MARIA,51227908,5992,1071,295,6.3959715732,5431,2.2997216085,4488,549,133,4.1280863166,3934,2.5656346382,1504,233,32,13.163437685,1497,1.6009227715,522,162
2024-2025,4,11,GaspÃ©sie-Ãles-de-la-Madeleine,CISSS DES ÃLES,HÃPITAL DE L'ARCHIPEL,51227783,5578,840,164,4.7554392753,4864,1.9865636422,4540,563,88,3.4555234337,3838,2.0937957414,1038,97,13,10.441005673,1026,1.5854361598,277,76
2024-2025,4,12,ChaudiÃ¨re-Appalaches,CISSS DE CHAUDIÃRE-APPALACHES,CHSLD ET HÃPITAL PAUL-GILBERT,51245199,13874,1201,155,2.7746179705,10811,2.213241837,13857,1196,155,2.7745160689,10794,2.2161370514,17,0,0,2.8576797386,17,0.3749509804,5,0
2024-2025,4,12,ChaudiÃ¨re-Appalaches,CISSS DE CHAUDIÃRE-APPALACHES,HÃPITAL DE MONTMAGNY,51245223,12069,1861,371,4.3280099382,11195,1.5344489852,9618,1046,207,2.5940219727,8748,1.7747836331,2451,260,13,11.132373974,2447,0.6752550742,815,164
2024-2025,4,12,ChaudiÃ¨re-Appalaches,CISSS DE CHAUDIÃRE-APPALACHES,HÃPITAL DE SAINT-GEORGES,51228971,14622,2789,694,6.3791133794,12187,2.5491761485,10285,1176,324,4.2027238967,7865,3.2430057569,4337,418,23,11.540322932,4322,1.2865732171,1613,370
2024-2025,4,12,ChaudiÃ¨re-Appalaches,CISSS DE CHAUDIÃRE-APPALACHES,HÃPITAL DE THETFORD,51245231,13867,2385,445,6.1472110045,12335,2.3742051074,11152,1322,231,4.4022683276,9624,2.70645588,2715,429,24,13.314651422,2711,1.1947209927,1063,214
2024-2025,4,12,ChaudiÃ¨re-Appalaches,CISSS DE CHAUDIÃRE-APPALACHES,HÃTEL-DIEU DE LÃVIS,51227569,25425,5150,1682,8.852401759,22473,1.758510991,17490,2074,769,3.8684852138,14544,2.2825485309,7935,2187,816,19.837745222,7929,0.7972798167,3076,913
2024-2025,4,13,Laval,CISSS DE LAVAL,HÃPITAL DE LA CITÃ-DE-LA-SANTÃ,51228757,30184,5850,2007,10.09892928,23626,3.6052236119,18820,1816,416,6.2666569695,12305,4.6793531085,11364,2398,160,16.445582297,11321,2.4377328024,4034,1591
2024-2025,4,14,LanaudiÃ¨re,CISSS DE LANAUDIÃRE,HÃPITAL DE LANAUDIÃRE ET CENTRE D'HÃBERGEMENT PARPHILIA-FERLAND,51244945,23923,4373,1678,9.2359288481,19245,2.6129232701,15253,1321,1155,5.4287806952,10624,3.5188290401,8670,2056,235,15.933787069,8621,1.4965396835,3052,523
2024-2025,4,14,LanaudiÃ¨re,CISSS DE LANAUDIÃRE,HÃPITAL PIERRE-LE GARDEUR,51228062,25213,4764,1458,10.300087741,17419,4.482297874,16897,1613,488,5.959829983,9135,5.3787532081,8316,2633,197,19.118911135,8284,3.4937513413,3151,970
2024-2025,4,15,Laurentides,CISSS DES LAURENTIDES,CENTRE MULTISERVICES DE SANTÃ ET DE SERVICES SOCIAUX D'ARGENTEUIL,51245306,6790,920,225,7.8058280151,5291,3.6772873223,5560,523,156,5.6375601519,4066,4.230666571,1230,284,51,17.607103884,1225,1.8405199546,397,69
2024-2025,4,15,Laurentides,CISSS DES LAURENTIDES,CENTRE MULTISERVICES DE SANTÃ ET DE SERVICES SOCIAUX DE RIVIÃRE-ROUGE,51217628,4603,585,227,6.862260603,3899,3.1773265225,3512,317,114,4.4931743546,2830,3.3806828622,1091,207,48,14.488503412,1069,2.638974379,268,113
2024-2025,4,15,Laurentides,CISSS DES LAURENTIDES,CENTRE MULTISERVICES DE SANTÃ ET DE SERVICES SOCIAUX DE SAINTE-AGATHE,51246874,10708,2015,652,10.784939557,8358,4.0963420941,7118,827,207,6.4802334067,4794,5.221497126,3590,1026,188,19.320008743,3564,2.582875982,1188,445
2024-2025,4,15,Laurentides,CISSS DES LAURENTIDES,HÃPITAL DE MONT-LAURIER,51217610,6213,917,283,9.2756636175,5009,3.3463992591,4664,473,139,5.9597040571,3482,3.6767730072,1549,441,121,19.259934366,1527,2.5930519173,444,144
2024-2025,4,15,Laurentides,CISSS DES LAURENTIDES,HÃPITAL DE SAINT-EUSTACHE,51228864,17211,3630,1022,12.103779124,12768,3.4523761879,10106,991,238,6.6439433945,5707,4.9292127115,7105,2277,466,19.869732661,7061,2.2587342051,2639,784
2024-2025,4,15,Laurentides,CISSS DES LAURENTIDES,HÃPITAL DE SAINT-JÃRÃME,51228880,19858,3725,1945,14.770741165,15094,3.9751867924,11385,1148,557,6.3468372859,6668,5.2409978421,8473,3024,1444,26.089771693,8426,2.973474464,2577,1388
2024-2025,4,16,MontÃ©rÃ©gie,CISSS DE LA MONTÃRÃGIE-CENTRE,HÃPITAL CHARLES-LE MOYNE,51233799,24981,4666,2035,10.142558489,14264,4.870420172,17149,1861,789,5.662114733,6439,5.7072522476,7832,2705,244,19.952968342,7825,4.1818116436,2805,1246
2024-2025,4,16,MontÃ©rÃ©gie,CISSS DE LA MONTÃRÃGIE-CENTRE,HÃPITAL DU HAUT-RICHELIEU,51229045,19664,3574,1237,11.705082624,14183,4.706528336,13719,1428,392,6.8294301091,8273,5.944702345,5945,2078,898,22.956399168,5910,2.9732942282,2146,845
2024-2025,4,16,MontÃ©rÃ©gie,CISSS DE LA MONTÃRÃGIE-EST,HÃPITAL HONORÃ-MERCIER,51229193,15305,3167,882,10.017743203,11364,4.9447245688,8290,1120,348,6.3238257271,4435,6.5570559314,7015,1295,190,14.383042686,6929,3.9127301118,2047,534
2024-2025,4,16,MontÃ©rÃ©gie,CISSS DE LA MONTÃRÃGIE-EST,HÃPITAL PIERRE-BOUCHER,51229011,18655,4154,1172,12.591689598,13748,4.9947952025,8716,1256,352,6.5767303745,3914,6.7761972691,9939,2434,766,17.866504427,9834,4.285784862,2898,820
2024-2025,4,16,MontÃ©rÃ©gie,CISSS DE LA MONTÃRÃGIE-EST,HÃTEL-DIEU DE SOREL,51229102,12111,2155,602,8.2303931687,10181,2.7960024938,8296,899,191,4.4437990531,6404,3.185309095,3815,977,169,16.46462247,3777,2.1359232048,1256,411
2024-2025,4,16,MontÃ©rÃ©gie,CISSS DE LA MONTÃRÃGIE-OUEST,HÃPITAL ANNA-LABERGE,51229151,12131,2608,837,15.794754509,9884,1.8658395724,6966,678,174,8.1260311992,4719,3.374503779,5165,2075,831,26.137508928,5165,0.4874491772,1930,663
2024-2025,4,16,MontÃ©rÃ©gie,CISSS DE LA MONTÃRÃGIE-OUEST,HÃPITAL BARRIE MEMORIAL / BARRIE MEMORIAL HOSPITAL,51228005,7425,785,140,6.3425246914,6195,3.3731645144,6355,501,115,4.7496686773,5126,3.4343190489,1070,234,31,15.802898494,1069,3.0799202266,284,25
2024-2025,4,16,MontÃ©rÃ©gie,CISSS DE LA MONTÃRÃGIE-OUEST,HÃPITAL DU SUROÃT,51229136,13548,2619,1130,12.459514627,10415,2.5763580039,7664,620,605,4.7772396558,4768,3.5311973923,5884,1699,858,22.465795283,5647,1.7701468823,1999,525
