Circonscriptions,Population_totale_1891,Canadiens_francais_1891,Population_totale_1901,Canadiens_francais_1901,Electeurs_inscrits,Votes_exprimes,Bulletins_rejetes,Votes_valides,Abstentions,Parti_liberal,Parti_conservateur,Autres_liberal,Autres_conservateur,Autres_independants,Autres_ouvrier
Argenteuil,15158,5951,16407,7391,3032,2152,31,2121,880,1117,1004,,,,
Arthabaska,27284,26225,23947,23185,4934,3581,6,3575,1353,2184,1391,,,,
Bagot,21695,21375,16291,16038,4335,3485,36,3449,850,1701,1748,,,,
Beauce,37222,36076,43129,42192,7998,6039,52,5987,1959,3371,2616,,,,
Beauharnois,16662,15370,21732,19506,3957,3224,38,3186,733,1729,1457,,,,
Bellechasse,18368,18332,18706,18640,3697,3041,23,3018,656,1726,1292,,,,
Berthier,19836,19539,18982,18672,4210,2877,20,2857,1333,1457,1400,,,,
Bonaventure,20835,13287,24495,17056,3995,3061,46,3015,934,1839,1176,,,,
Brome,14709,4839,13397,4766,3886,2931,52,2879,955,1617,1262,,,,
Chambly,11704,10139,12779,10926,3362,2354,25,2329,1008,1280,,,,1049,
Champlain,29267,28284,35159,34293,5910,4585,16,4569,1325,2177,2392,,,,
Charlevoix,19038,18896,19334,18979,3764,2834,41,2793,930,1389,1404,,,,
Châteauguay,13864,9660,15693,9415,3347,2268,51,2217,1079,1451,766,,,,
Chicoutimi-Saguenay,24233,21696,28135,24418,3456,2556,29,2527,900,,1661,,866,,
Compton,22779,10335,26460,14460,5857,3533,48,3485,2324,1894,1591,,,,
Deux-Montagnes,15027,13915,14438,13366,3328,2715,26,2689,613,1345,,,1344,,
Dorchester,19017,17132,21007,18106,4106,3033,24,3009,1073,1442,1567,,,,
Drummond,16639,13391,20537,17860,3479,2273,26,2247,1206,1269,978,,,,
Gaspé,21933,14975,24657,17526,3521,2932,83,2849,589,1419,1430,,,,
Hochelaga,80998,58522,142826,104069,27583,14503,145,14358,13080,8103,6255,,,,
Huntingdon,14385,4489,13979,5105,3402,2402,26,2376,1000,1318,,1058,,,
Iberville,11893,11132,9673,9184,2624,1417,16,1401,1207,1044,357,,,,
Îles-de-la-Madeleine,4942,4431,6026,5259,1038,895,17,878,143,469,,409,,,
Jacques-Cartier,13832,11856,14934,12293,4330,3093,21,3072,1237,1541,1531,,,,
Joliette,22921,22330,22255,21662,4569,3531,51,3480,1038,1733,1747,,,,
Kamouraska,20454,20411,19099,19012,3760,2864,35,2829,896,1439,1390,,,,
Lac-Saint-Jean,14048,13960,20156,19871,4065,2799,32,2767,1266,1212,1555,,,,
Laprairie,10900,8974,8947,8729,2100,1711,17,1694,389,900,794,,,,
L'Assomption,13674,13327,14993,14661,3056,2467,16,2451,589,1118,1333,,,,
Laval,9436,9173,10248,9916,2147,1870,9,1861,277,838,1023,,,,
Lévis,25995,24848,26210,25068,5532,4058,40,4018,1474,2546,1472,,,,
L'Islet,13823,13805,14439,14413,2924,2198,27,2171,726,1186,985,,,,
Lotbinière,20688,19128,20039,18817,4246,2830,15,2815,1416,1692,1123,,,,
Maskinongé,17829,17755,15813,15563,3446,2396,15,2381,1050,1422,959,,,,
Matane,14621,14139,20456,19162,3529,2676,26,2650,853,1427,1223,,,,
Mégantic,22233,16631,23621,18721,5133,3913,24,3889,1220,2078,1811,,,,
Missisquoi,18549,9337,18482,9908,4673,3460,45,3415,1213,1910,1505,,,,
Montcalm,12131,11023,13001,12020,2900,2038,12,2026,862,1056,970,,,,
Montmagny,14726,14695,14757,14663,2929,1938,39,1899,991,952,,947,,,
Montmorency,12309,12085,12311,12124,2533,2065,13,2052,468,999,1053,,,,
Montréal-No. 1 (Sainte-Marie),34746,28662,40631,32850,8934,5061,81,4980,3873,2947,2033,,,,
Montréal-No. 2 (Saint-Jacques),35830,31879,42618,37081,8159,5193,38,5155,2966,2962,2193,,,,
Montréal-No. 3 (Saint-Louis),24924,17084,26919,16877,5281,3325,43,3282,1956,1952,1330,,,,
Montréal-No. 4 (Saint-Laurent),17884,4386,21889,5401,5136,3018,44,2974,2118,1350,1624,,,,
Montréal-No. 5 (Saint-Georges),44626,11267,47653,14597,8732,4619,57,4562,4113,2289,2273,,,,
Montréal-No. 6 (Sainte-Anne),24685,6712,23368,7439,8610,5069,83,4986,3541,2534,2452,,,,
Napierville,10101,9671,8576,8161,2133,1575,25,1550,558,877,673,,,,
Nicolet,28735,28374,26590,26121,6428,4829,26,4803,1599,2222,2581,,,,
Ottawa,63560,42285,75731,54599,13426,6639,33,6606,6787,3616,2990,,,,
Pontiac,22084,6663,25722,9397,4702,4702,,,,Élu sans opposition,,,,,
Portneuf,25813,24102,27159,25669,5322,4405,23,4382,917,2302,2080,,,,
Québec-Centre,12936,9577,20366,15297,3877,3119,24,3095,758,1721,1374,,,,
Québec-Comté,19503,16373,22101,18710,4232,2313,27,2286,1919,1693,593,,,,
Québec-Est,17511,16473,18894,17331,4054,2542,10,2532,1512,1729,803,,,,
Québec-Ouest,13954,7421,9149,4911,2238,1671,33,1638,567,502,726,410,,,
Richelieu,21354,21098,18576,18189,4266,3127,39,3088,1139,1610,1478,,,,
Richmond,16329,8644,17821,10812,4690,3336,36,3300,1354,1552,1748,,,,
Rimouski,18809,18686,19701,19303,2714,2200,37,2163,514,1202,961,,,,
Rouville,16012,15644,15990,15458,3445,2671,16,2655,774,1327,1328,,,,
Saint-Hyacinthe,21433,21169,21543,21302,5155,3962,41,3921,1193,2329,1592,,,,
Saint-Jean,12282,10234,9863,8957,2695,1976,34,1942,719,1164,778,,,,
Saint-Maurice,12267,12087,15428,14962,3078,,,,,,Élu sans opposition,,,,
Saint-Sauveur,18689,17802,20431,19477,2967,2195,34,2161,772,1773,,,,,388
Shefford,23263,17888,23628,18086,5942,4403,24,4379,1539,2373,2006,,,,
Sherbrooke,16088,8672,18426,10645,3894,2094,27,2067,1800,784,1283,,,,
Soulanges,9608,8909,9928,9269,2388,1910,41,1869,478,1056,813,,,,
Stanstead,18067,6933,18998,8744,4866,3566,48,3518,1300,1721,1797,,,,
Témiscouata,25698,25189,29185,28320,4762,3693,48,3645,1069,2217,1409,19,,,
Terrebonne,23128,21770,26816,25424,5178,4019,23,3996,1159,1853,2143,,,,
Trois-Rivières,8834,8373,10739,10219,1564,1259,9,1250,305,513,737,,,,
Vaudreuil,10792,9539,10445,9352,2747,1857,20,1837,890,1091,746,,,,
Verchères,12257,12176,11539,11343,2657,2059,10,2049,598,1089,912,48,,,
Wolfe,15018,13424,16316,14885,3496,2355,12,2343,1141,821,1522,,,,
Yamaska,16058,15712,16204,15767,4339,3514,33,3481,825,1739,1742,,,,
